8,google,node,128,europe-west1,8533,4519,4014,Google 128 MB, 128 MB
8,google,node,128,europe-west1,7933,4414,3519,Google 128 MB, 128 MB
8,google,node,128,europe-west1,5021,2822,2199,Google 128 MB, 128 MB
8,google,node,128,europe-west1,21870,21596,274,Google 128 MB, 128 MB
8,google,node,128,europe-west1,5495,2943,2552,Google 128 MB, 128 MB
8,google,node,128,europe-west1,17274,17056,218,Google 128 MB, 128 MB
8,google,node,128,europe-west1,6097,3494,2603,Google 128 MB, 128 MB
8,google,node,128,europe-west1,19571,19069,502,Google 128 MB, 128 MB
8,google,node,128,europe-west1,18765,18514,251,Google 128 MB, 128 MB
8,google,node,128,europe-west1,18664,18500,164,Google 128 MB, 128 MB
8,google,node,128,europe-west1,17571,17448,123,Google 128 MB, 128 MB
8,google,node,128,europe-west1,17889,17742,147,Google 128 MB, 128 MB
8,google,node,128,europe-west1,17070,16948,122,Google 128 MB, 128 MB
8,google,node,128,europe-west1,18964,18298,666,Google 128 MB, 128 MB
8,google,node,128,europe-west1,17356,17227,129,Google 128 MB, 128 MB
8,google,node,128,europe-west1,19365,17208,2157,Google 128 MB, 128 MB
8,google,node,128,europe-west1,22871,22740,131,Google 128 MB, 128 MB
8,google,node,128,europe-west1,19160,19018,142,Google 128 MB, 128 MB
8,google,node,128,europe-west1,24565,24384,181,Google 128 MB, 128 MB
8,google,node,128,europe-west1,17851,17605,246,Google 128 MB, 128 MB
8,google,node,128,europe-west1,24467,24208,259,Google 128 MB, 128 MB
8,google,node,128,europe-west1,24562,24388,174,Google 128 MB, 128 MB
8,google,node,128,europe-west1,18154,18024,130,Google 128 MB, 128 MB
8,google,node,128,europe-west1,23957,23601,356,Google 128 MB, 128 MB
8,google,node,128,europe-west1,18548,18392,156,Google 128 MB, 128 MB
8,google,node,128,europe-west1,24063,23902,161,Google 128 MB, 128 MB
8,google,node,128,europe-west1,26145,25818,327,Google 128 MB, 128 MB
8,google,node,128,europe-west1,23570,23347,223,Google 128 MB, 128 MB
8,google,node,128,europe-west1,20839,20689,150,Google 128 MB, 128 MB
8,google,node,128,europe-west1,20946,20798,148,Google 128 MB, 128 MB
8,google,node,128,europe-west1,22379,22101,278,Google 128 MB, 128 MB
8,google,node,128,europe-west1,19334,19104,230,Google 128 MB, 128 MB
8,google,node,128,europe-west1,23666,23516,150,Google 128 MB, 128 MB
8,google,node,128,europe-west1,18331,18194,137,Google 128 MB, 128 MB
8,google,node,128,europe-west1,24868,24655,213,Google 128 MB, 128 MB
8,google,node,128,europe-west1,6000,3285,2715,Google 128 MB, 128 MB
8,google,node,128,europe-west1,5343,3065,2278,Google 128 MB, 128 MB
8,google,node,128,europe-west1,17229,17093,136,Google 128 MB, 128 MB
8,google,node,128,europe-west1,22842,22395,447,Google 128 MB, 128 MB
8,google,node,128,europe-west1,22332,22145,187,Google 128 MB, 128 MB
8,google,node,128,europe-west1,16019,15697,322,Google 128 MB, 128 MB
8,google,node,128,europe-west1,21834,21667,167,Google 128 MB, 128 MB
8,google,node,128,europe-west1,15180,14995,185,Google 128 MB, 128 MB
8,google,node,128,europe-west1,15019,14700,319,Google 128 MB, 128 MBB
8,google,node,128,europe-west1,20824,20593,231,Google 128 MB, 128 MB
8,google,node,128,europe-west1,19318,19188,130,Google 128 MB, 128 MB
8,google,node,128,europe-west1,14564,14395,169,Google 128 MB, 128 MB
8,google,node,128,europe-west1,16213,15997,216,Google 128 MB, 128 MB
8,google,node,128,europe-west1,15106,14896,210,Google 128 MB, 128 MB
8,google,node,128,europe-west1,18812,18599,213,Google 128 MB, 128 MB
8,google,node,128,europe-west1,14863,14734,129,Google 128 MB, 128 MB
8,google,node,128,europe-west1,14900,14509,391,Google 128 MB, 128 MB
8,google,node,128,europe-west1,16108,15804,304,Google 128 MB, 128 MBB
8,google,node,128,europe-west1,14818,14685,133,Google 128 MB, 128 MBB
8,google,node,128,europe-west1,20522,20202,320,Google 128 MB, 128 MBB
8,google,node,128,europe-west1,15554,15401,153,Google 128 MB, 128 MB
8,google,node,128,europe-west1,20811,20671,140,Google 128 MB, 128 MB
8,google,node,128,europe-west1,14400,14248,152,Google 128 MB, 128 MB
8,google,node,128,europe-west1,15698,15488,210,Google 128 MB, 128 MB
8,google,node,128,europe-west1,16252,15206,1046,Google 128 MB, 128 MB
8,google,node,128,europe-west1,14779,14645,134,Google 128 MB, 128 MB
8,google,node,128,europe-west1,16875,16605,270,Google 128 MB, 128 MB
8,google,node,128,europe-west1,15477,15290,187,Google 128 MB, 128 MB
8,google,node,128,europe-west1,14564,14393,171,Google 128 MB, 128 MB
8,google,node,128,europe-west1,15451,15314,137,Google 128 MB, 128 MB
8,google,node,128,europe-west1,17286,17142,144,Google 128 MB, 128 MB
8,google,node,128,europe-west1,15164,15045,119,Google 128 MB, 128 MB
8,google,node,128,europe-west1,15066,14933,133,Google 128 MB, 128 MB
8,google,node,128,europe-west1,15918,15688,230,Google 128 MB, 128 MB
8,google,node,128,europe-west1,16678,16554,124,Google 128 MB, 128 MB
8,google,node,128,europe-west1,14565,14402,163,Google 128 MB, 128 MB
8,google,node,128,europe-west1,15263,15087,176,Google 128 MB, 128 MB
8,google,node,128,europe-west1,16217,16097,120,Google 128 MB, 128 MB
8,google,node,128,europe-west1,16571,16441,130,Google 128 MB, 128 MB
8,google,node,128,europe-west1,15055,14936,119,Google 128 MB, 128 MB
8,google,node,128,europe-west1,15963,15701,262,Google 128 MB, 128 MB
8,google,node,128,europe-west1,16512,16285,227,Google 128 MB, 128 MB
8,google,node,128,europe-west1,14751,14637,114,Google 128 MB, 128 MB
8,google,node,128,europe-west1,17563,17422,141,Google 128 MB, 128 MB
8,google,node,128,europe-west1,14659,14491,168,Google 128 MB, 128 MB
8,google,node,128,europe-west1,15147,14603,544,Google 128 MB, 128 MB
8,google,node,128,europe-west1,15893,15579,314,Google 128 MB, 128 MB
8,google,node,128,europe-west1,14354,14201,153,Google 128 MB, 128 MB
8,google,node,128,europe-west1,16849,16729,120,Google 128 MB, 128 MB
8,google,node,128,europe-west1,15039,14806,233,Google 128 MB, 128 MB
8,google,node,128,europe-west1,15138,15008,130,Google 128 MB, 128 MB
8,google,node,128,europe-west1,16094,15901,193,Google 128 MB, 128 MB
8,google,node,128,europe-west1,17446,17318,128,Google 128 MB, 128 MB
8,google,node,128,europe-west1,15493,14889,604,Google 128 MB, 128 MB
8,google,node,128,europe-west1,16029,15898,131,Google 128 MB, 128 MB
8,google,node,128,europe-west1,15290,15097,193,Google 128 MB, 128 MB
8,google,node,128,europe-west1,16047,15900,147,Google 128 MB, 128 MB
8,google,node,128,europe-west1,17256,17089,167,Google 128 MB, 128 MB
8,google,node,128,europe-west1,15051,14932,119,Google 128 MB, 128 MB
8,google,node,128,europe-west1,15694,15574,120,Google 128 MB, 128 MB
8,google,node,128,europe-west1,15536,15385,151,Google 128 MB, 128 MB
8,google,node,128,europe-west1,15439,15306,133,Google 128 MB, 128 MB
8,google,node,128,europe-west1,16944,16798,146,Google 128 MB, 128 MB
8,google,node,128,europe-west1,14852,14716,136,Google 128 MB, 128 MB
8,google,node,128,europe-west1,14829,14701,128,Google 128 MB, 128 MB
9,google,node,256,europe-west1,5243,2715,2528,Google 256 MB, 256 MB
9,google,node,256,europe-west1,6327,6214,113,Google 256 MB, 256 MB
9,google,node,256,europe-west1,7733,6387,1346,Google 256 MB, 256 MB
9,google,node,256,europe-west1,9013,6204,2809,Google 256 MB, 256 MB
9,google,node,256,europe-west1,10126,6100,4026,Google 256 MB, 256 MB
9,google,node,256,europe-west1,12006,6791,5215,Google 256 MB, 256 MB
9,google,node,256,europe-west1,10449,3004,7445,Google 256 MB, 256 MB
9,google,node,256,europe-west1,10500,8484,2016,Google 256 MB, 256 MB
9,google,node,256,europe-west1,8903,8446,457,Google 256 MB, 256 MB
9,google,node,256,europe-west1,8026,7504,522,Google 256 MB, 256 MB
9,google,node,256,europe-west1,7715,7520,195,Google 256 MB, 256 MB
9,google,node,256,europe-west1,8392,8187,205,Google 256 MB, 256 MB
9,google,node,256,europe-west1,8679,8204,475,Google 256 MB, 256 MB
9,google,node,256,europe-west1,9099,8988,111,Google 256 MB, 256 MB
9,google,node,256,europe-west1,9696,9577,119,Google 256 MB, 256 MB
9,google,node,256,europe-west1,10374,9978,396,Google 256 MB, 256 MB
9,google,node,256,europe-west1,10699,10258,441,Google 256 MB, 256 MB
9,google,node,256,europe-west1,8884,8422,462,Google 256 MB, 256 MB
9,google,node,256,europe-west1,7939,7807,132,Google 256 MB, 256 MB
9,google,node,256,europe-west1,8379,8198,181,Google 256 MB, 256 MB
9,google,node,256,europe-west1,8088,7898,190,Google 256 MB, 256 MB
9,google,node,256,europe-west1,8550,8188,362,Google 256 MB, 256 MB
9,google,node,256,europe-west1,11422,8001,3421,Google 256 MB, 256 MB
9,google,node,256,europe-west1,10322,2849,7473,Google 256 MB, 256 MB
9,google,node,256,europe-west1,15324,8895,6429,Google 256 MB, 256 MB
9,google,node,256,europe-west1,10815,10478,337,Google 256 MB, 256 MB
9,google,node,256,europe-west1,17409,12009,5400,Google 256 MB, 256 MB
9,google,node,256,europe-west1,17127,11222,5905,Google 256 MB, 256 MB
9,google,node,256,europe-west1,7854,7733,121,Google 256 MB, 256 MB
9,google,node,256,europe-west1,13517,11025,2492,Google 256 MB, 256 MB
9,google,node,256,europe-west1,7467,7336,131,Google 256 MB, 256 MB
9,google,node,256,europe-west1,9401,9275,126,Google 256 MB, 256 MB
9,google,node,256,europe-west1,9225,9088,137,Google 256 MB, 256 MB
9,google,node,256,europe-west1,7663,7548,115,Google 256 MB, 256 MB
9,google,node,256,europe-west1,8470,8302,168,Google 256 MB, 256 MB
9,google,node,256,europe-west1,8796,8390,406,Google 256 MB, 256 MB
9,google,node,256,europe-west1,7626,7438,188,Google 256 MB, 256 MB
9,google,node,256,europe-west1,8794,8587,207,Google 256 MB, 256 MB
9,google,node,256,europe-west1,7054,6926,128,Google 256 MB, 256 MB
9,google,node,256,europe-west1,7834,7713,121,Google 256 MB, 256 MB
9,google,node,256,europe-west1,7438,7280,158,Google 256 MB, 256 MB
9,google,node,256,europe-west1,9477,9359,118,Google 256 MB, 256 MB
9,google,node,256,europe-west1,9383,9264,119,Google 256 MB, 256 MB
9,google,node,256,europe-west1,6730,6612,118,Google 256 MB, 256 MB
9,google,node,256,europe-west1,9382,9257,125,Google 256 MB, 256 MB
9,google,node,256,europe-west1,11760,11590,170,Google 256 MB, 256 MB
9,google,node,256,europe-west1,10057,9934,123,Google 256 MB, 256 MB
9,google,node,256,europe-west1,6909,6698,211,Google 256 MB, 256 MB
9,google,node,256,europe-west1,9650,9532,118,Google 256 MB, 256 MB
9,google,node,256,europe-west1,9760,9613,147,Google 256 MB, 256 MB
9,google,node,256,europe-west1,7015,6802,213,Google 256 MB, 256 MB
9,google,node,256,europe-west1,8933,8786,147,Google 256 MB, 256 MB
9,google,node,256,europe-west1,9542,9390,152,Google 256 MB, 256 MB
9,google,node,256,europe-west1,6907,6800,107,Google 256 MB, 256 MB
9,google,node,256,europe-west1,7085,6965,120,Google 256 MB, 256 MB
9,google,node,256,europe-west1,8331,7726,605,Google 256 MB, 256 MB
9,google,node,256,europe-west1,6696,6578,118,Google 256 MB, 256 MB
9,google,node,256,europe-west1,7764,7416,348,Google 256 MB, 256 MB
9,google,node,256,europe-west1,7009,6810,199,Google 256 MB, 256 MB
9,google,node,256,europe-west1,7733,7627,106,Google 256 MB, 256 MB
9,google,node,256,europe-west1,7590,7481,109,Google 256 MB, 256 MB
9,google,node,256,europe-west1,7594,7474,120,Google 256 MB, 256 MB
9,google,node,256,europe-west1,8934,8795,139,Google 256 MB, 256 MB
9,google,node,256,europe-west1,10924,10776,148,Google 256 MB, 256 MB
9,google,node,256,europe-west1,9741,9618,123,Google 256 MB, 256 MB
9,google,node,256,europe-west1,7599,7456,143,Google 256 MB, 256 MB
9,google,node,256,europe-west1,8177,8062,115,Google 256 MB, 256 MB
9,google,node,256,europe-west1,7778,7644,134,Google 256 MB, 256 MB
9,google,node,256,europe-west1,7192,7076,116,Google 256 MB, 256 MB
9,google,node,256,europe-west1,8721,8594,127,Google 256 MB, 256 MB
9,google,node,256,europe-west1,9017,8878,139,Google 256 MB, 256 MB
9,google,node,256,europe-west1,7280,6859,421,Google 256 MB, 256 MB
9,google,node,256,europe-west1,8525,8389,136,Google 256 MB, 256 MB
9,google,node,256,europe-west1,7874,7603,271,Google 256 MB, 256 MB
9,google,node,256,europe-west1,7780,7604,176,Google 256 MB, 256 MB
9,google,node,256,europe-west1,7618,7402,216,Google 256 MB, 256 MB
9,google,node,256,europe-west1,7666,7481,185,Google 256 MB, 256 MB
9,google,node,256,europe-west1,9131,8589,542,Google 256 MB, 256 MB
9,google,node,256,europe-west1,7863,7758,105,Google 256 MB, 256 MB
9,google,node,256,europe-west1,7511,7307,204,Google 256 MB, 256 MB
9,google,node,256,europe-west1,7556,7449,107,Google 256 MB, 256 MB
9,google,node,256,europe-west1,8623,8407,216,Google 256 MB, 256 MB
9,google,node,256,europe-west1,8692,8541,151,Google 256 MB, 256 MB
9,google,node,256,europe-west1,7624,7514,110,Google 256 MB, 256 MB
9,google,node,256,europe-west1,8609,8486,123,Google 256 MB, 256 MB
9,google,node,256,europe-west1,7809,7694,115,Google 256 MB, 256 MB
9,google,node,256,europe-west1,9341,9221,120,Google 256 MB, 256 MB
9,google,node,256,europe-west1,11128,10890,238,Google 256 MB, 256 MB
9,google,node,256,europe-west1,10806,10683,123,Google 256 MB, 256 MB
9,google,node,256,europe-west1,12505,11302,1203,Google 256 MB, 256 MB
9,google,node,256,europe-west1,10927,10097,830,Google 256 MB, 256 MB
9,google,node,256,europe-west1,7576,7411,165,Google 256 MB, 256 MB
9,google,node,256,europe-west1,10013,9881,132,Google 256 MB, 256 MB
9,google,node,256,europe-west1,9723,9506,217,Google 256 MB, 256 MB
9,google,node,256,europe-west1,8160,7988,172,Google 256 MB, 256 MB
9,google,node,256,europe-west1,10065,9919,146,Google 256 MB, 256 MB
9,google,node,256,europe-west1,11275,11165,110,Google 256 MB, 256 MB
9,google,node,256,europe-west1,10966,10847,119,Google 256 MB, 256 MB
9,google,node,256,europe-west1,12455,11104,1351,Google 256 MB, 256 MB
9,google,node,256,europe-west1,10243,9273,970,Google 256 MB, 256 MB
10,google,node,512,europe-west1,3724,3495,229,Google 512 MB, 512 MB
10,google,node,512,europe-west1,3550,3420,130,Google 512 MB, 512 MB
10,google,node,512,europe-west1,4020,2088,1932,Google 512 MB, 512 MB
10,google,node,512,europe-west1,3385,3275,110,Google 512 MB, 512 MB
10,google,node,512,europe-west1,3306,3193,113,Google 512 MB, 512 MB
10,google,node,512,europe-west1,3677,3501,176,Google 512 MB, 512 MB
10,google,node,512,europe-west1,3411,3302,109,Google 512 MB, 512 MB
10,google,node,512,europe-west1,3613,3439,174,Google 512 MB, 512 MB
10,google,node,512,europe-west1,3612,3450,162,Google 512 MB, 512 MB
10,google,node,512,europe-west1,3692,3581,111,Google 512 MB, 512 MB
10,google,node,512,europe-west1,3786,3615,171,Google 512 MB, 512 MB
10,google,node,512,europe-west1,3280,3116,164,Google 512 MB, 512 MB
10,google,node,512,europe-west1,3265,3107,158,Google 512 MB, 512 MB
10,google,node,512,europe-west1,3368,3208,160,Google 512 MB, 512 MB
10,google,node,512,europe-west1,3459,3293,166,Google 512 MB, 512 MB
10,google,node,512,europe-west1,3408,3238,170,Google 512 MB, 512 MB
10,google,node,512,europe-west1,3377,3228,149,Google 512 MB, 512 MB
10,google,node,512,europe-west1,3486,3324,162,Google 512 MB, 512 MB
10,google,node,512,europe-west1,3390,3264,126,Google 512 MB, 512 MB
10,google,node,512,europe-west1,3370,3211,159,Google 512 MB, 512 MB
10,google,node,512,europe-west1,3795,3572,223,Google 512 MB, 512 MB
10,google,node,512,europe-west1,3496,3283,213,Google 512 MB, 512 MB
10,google,node,512,europe-west1,3510,3318,192,Google 512 MB, 512 MB
10,google,node,512,europe-west1,3503,3305,198,Google 512 MB, 512 MB
10,google,node,512,europe-west1,3432,3240,192,Google 512 MB, 512 MB
10,google,node,512,europe-west1,3312,3122,190,Google 512 MB, 512 MB
10,google,node,512,europe-west1,3490,3302,188,Google 512 MB, 512 MB
10,google,node,512,europe-west1,3514,3392,122,Google 512 MB, 512 MB
10,google,node,512,europe-west1,3526,3336,190,Google 512 MB, 512 MB
10,google,node,512,europe-west1,3904,3427,477,Google 512 MB, 512 MB
10,google,node,512,europe-west1,3819,3625,194,Google 512 MB, 512 MB
10,google,node,512,europe-west1,3517,3320,197,Google 512 MB, 512 MB
10,google,node,512,europe-west1,3468,3314,154,Google 512 MB, 512 MB
10,google,node,512,europe-west1,3799,3586,213,Google 512 MB, 512 MB
10,google,node,512,europe-west1,3826,3651,175,Google 512 MB, 512 MB
10,google,node,512,europe-west1,3572,3381,191,Google 512 MB, 512 MB
10,google,node,512,europe-west1,3685,3503,182,Google 512 MB, 512 MB
10,google,node,512,europe-west1,3913,3732,181,Google 512 MB, 512 MB
10,google,node,512,europe-west1,3880,3697,183,Google 512 MB, 512 MB
10,google,node,512,europe-west1,3871,3704,167,Google 512 MB, 512 MB
10,google,node,512,europe-west1,3596,3418,178,Google 512 MB, 512 MB
10,google,node,512,europe-west1,3571,3397,174,Google 512 MB, 512 MB
10,google,node,512,europe-west1,3663,3503,160,Google 512 MB, 512 MB
10,google,node,512,europe-west1,3657,3487,170,Google 512 MB, 512 MB
10,google,node,512,europe-west1,3876,3710,166,Google 512 MB, 512 MB
10,google,node,512,europe-west1,3681,3517,164,Google 512 MB, 512 MB
10,google,node,512,europe-west1,4605,4452,153,Google 512 MB, 512 MB
10,google,node,512,europe-west1,3599,3479,120,Google 512 MB, 512 MB
10,google,node,512,europe-west1,3405,3246,159,Google 512 MB, 512 MB
10,google,node,512,europe-west1,3694,3289,405,Google 512 MB, 512 MB
10,google,node,512,europe-west1,3489,3321,168,Google 512 MB, 512 MB
10,google,node,512,europe-west1,3685,3528,157,Google 512 MB, 512 MB
10,google,node,512,europe-west1,3869,3512,357,Google 512 MB, 512 MB
10,google,node,512,europe-west1,4207,4039,168,Google 512 MB, 512 MB
10,google,node,512,europe-west1,3579,3462,117,Google 512 MB, 512 MB
10,google,node,512,europe-west1,3672,3509,163,Google 512 MB, 512 MB
10,google,node,512,europe-west1,3866,3557,309,Google 512 MB, 512 MB
10,google,node,512,europe-west1,4124,3949,175,Google 512 MB, 512 MB
10,google,node,512,europe-west1,3866,3704,162,Google 512 MB, 512 MB
10,google,node,512,europe-west1,3487,3365,122,Google 512 MB, 512 MB
10,google,node,512,europe-west1,3782,3633,149,Google 512 MB, 512 MB
10,google,node,512,europe-west1,3736,3590,146,Google 512 MB, 512 MB
10,google,node,512,europe-west1,3672,3536,136,Google 512 MB, 512 MB
10,google,node,512,europe-west1,3553,3409,144,Google 512 MB, 512 MB
10,google,node,512,europe-west1,3648,3530,118,Google 512 MB, 512 MB
10,google,node,512,europe-west1,3648,3510,138,Google 512 MB, 512 MB
10,google,node,512,europe-west1,3664,3527,137,Google 512 MB, 512 MB
10,google,node,512,europe-west1,3626,3399,227,Google 512 MB, 512 MB
10,google,node,512,europe-west1,3545,3425,120,Google 512 MB, 512 MB
10,google,node,512,europe-west1,3640,3520,120,Google 512 MB, 512 MB
10,google,node,512,europe-west1,3453,3339,114,Google 512 MB, 512 MB
10,google,node,512,europe-west1,5047,4886,161,Google 512 MB, 512 MB
10,google,node,512,europe-west1,4216,3882,334,Google 512 MB, 512 MB
10,google,node,512,europe-west1,4060,3843,217,Google 512 MB, 512 MB
10,google,node,512,europe-west1,4429,4289,140,Google 512 MB, 512 MB
10,google,node,512,europe-west1,5746,5476,270,Google 512 MB, 512 MB
10,google,node,512,europe-west1,5323,4554,769,Google 512 MB, 512 MB
10,google,node,512,europe-west1,3566,3415,151,Google 512 MB, 512 MB
10,google,node,512,europe-west1,3917,3353,564,Google 512 MB, 512 MB
10,google,node,512,europe-west1,3482,3379,103,Google 512 MB, 512 MB
10,google,node,512,europe-west1,3760,3288,472,Google 512 MB, 512 MB
10,google,node,512,europe-west1,3366,3260,106,Google 512 MB, 512 MB
10,google,node,512,europe-west1,3471,3346,125,Google 512 MB, 512 MB
10,google,node,512,europe-west1,3676,3520,156,Google 512 MB, 512 MB
10,google,node,512,europe-west1,3485,3325,160,Google 512 MB, 512 MB
10,google,node,512,europe-west1,3578,3427,151,Google 512 MB, 512 MB
10,google,node,512,europe-west1,4042,3882,160,Google 512 MB, 512 MB
10,google,node,512,europe-west1,3453,3342,111,Google 512 MB, 512 MB
10,google,node,512,europe-west1,3553,3393,160,Google 512 MB, 512 MB
10,google,node,512,europe-west1,3733,3420,313,Google 512 MB, 512 MB
10,google,node,512,europe-west1,3545,3437,108,Google 512 MB, 512 MB
10,google,node,512,europe-west1,3464,3342,122,Google 512 MB, 512 MB
10,google,node,512,europe-west1,3562,3324,238,Google 512 MB, 512 MB
10,google,node,512,europe-west1,3446,3344,102,Google 512 MB, 512 MB
10,google,node,512,europe-west1,3459,3348,111,Google 512 MB, 512 MB
10,google,node,512,europe-west1,3354,3219,135,Google 512 MB, 512 MB
10,google,node,512,europe-west1,3430,3307,123,Google 512 MB, 512 MB
10,google,node,512,europe-west1,3520,3291,229,Google 512 MB, 512 MB
10,google,node,512,europe-west1,3347,3241,106,Google 512 MB, 512 MB
10,google,node,512,europe-west1,3400,3279,121,Google 512 MB, 512 MB
11,google,node,1024,europe-west1,2278,1918,360,Google 1024 MB, 1024 MB
11,google,node,1024,europe-west1,2537,2308,229,Google 1024 MB, 1024 MB
11,google,node,1024,europe-west1,2229,2040,189,Google 1024 MB, 1024 MB
11,google,node,1024,europe-west1,2060,1874,186,Google 1024 MB, 1024 MB
11,google,node,1024,europe-west1,2126,1928,198,Google 1024 MB, 1024 MB
11,google,node,1024,europe-west1,2067,1923,144,Google 1024 MB, 1024 MB
11,google,node,1024,europe-west1,2146,1969,177,Google 1024 MB, 1024 MB
11,google,node,1024,europe-west1,1998,1862,136,Google 1024 MB, 1024 MB
11,google,node,1024,europe-west1,2083,1907,176,Google 1024 MB, 1024 MB
11,google,node,1024,europe-west1,1962,1851,111,Google 1024 MB, 1024 MB
11,google,node,1024,europe-west1,1988,1851,137,Google 1024 MB, 1024 MB
11,google,node,1024,europe-west1,2046,1869,177,Google 1024 MB, 1024 MB
11,google,node,1024,europe-west1,1986,1821,165,Google 1024 MB, 1024 MB
11,google,node,1024,europe-west1,2303,2134,169,Google 1024 MB, 1024 MB
11,google,node,1024,europe-west1,2000,1834,166,Google 1024 MB, 1024 MB
11,google,node,1024,europe-west1,2087,1921,166,Google 1024 MB, 1024 MB
11,google,node,1024,europe-west1,2033,1872,161,Google 1024 MB, 1024 MB
11,google,node,1024,europe-west1,2357,2182,175,Google 1024 MB, 1024 MB
11,google,node,1024,europe-west1,2260,2155,105,Google 1024 MB, 1024 MB
11,google,node,1024,europe-west1,1996,1862,134,Google 1024 MB, 1024 MB
11,google,node,1024,europe-west1,2109,1976,133,Google 1024 MB, 1024 MB
11,google,node,1024,europe-west1,2006,1837,169,Google 1024 MB, 1024 MB
11,google,node,1024,europe-west1,1971,1820,151,Google 1024 MB, 1024 MB
11,google,node,1024,europe-west1,1987,1835,152,Google 1024 MB, 1024 MB
11,google,node,1024,europe-west1,1958,1812,146,Google 1024 MB, 1024 MB
11,google,node,1024,europe-west1,1911,1820,91,Google 1024 MB, 1024 MB
11,google,node,1024,europe-west1,1973,1825,148,Google 1024 MB, 1024 MB
11,google,node,1024,europe-west1,2147,2003,144,Google 1024 MB, 1024 MB
11,google,node,1024,europe-west1,2610,2002,608,Google 1024 MB, 1024 MB
11,google,node,1024,europe-west1,2202,2058,144,Google 1024 MB, 1024 MB
11,google,node,1024,europe-west1,1972,1825,147,Google 1024 MB, 1024 MB
11,google,node,1024,europe-west1,1829,1771,58,Google 1024 MB, 1024 MB
11,google,node,1024,europe-west1,2002,1906,96,Google 1024 MB, 1024 MB
11,google,node,1024,europe-west1,1887,1748,139,Google 1024 MB, 1024 MB
11,google,node,1024,europe-west1,1948,1812,136,Google 1024 MB, 1024 MB
11,google,node,1024,europe-west1,1965,1829,136,Google 1024 MB, 1024 MB
11,google,node,1024,europe-west1,1901,1760,141,Google 1024 MB, 1024 MB
11,google,node,1024,europe-west1,2408,2279,129,Google 1024 MB, 1024 MB
11,google,node,1024,europe-west1,1886,1824,62,Google 1024 MB, 1024 MB
11,google,node,1024,europe-west1,1969,1842,127,Google 1024 MB, 1024 MB
11,google,node,1024,europe-west1,2063,1987,76,Google 1024 MB, 1024 MB
11,google,node,1024,europe-west1,2006,1888,118,Google 1024 MB, 1024 MB
11,google,node,1024,europe-west1,2023,1917,106,Google 1024 MB, 1024 MB
11,google,node,1024,europe-west1,2058,1941,117,Google 1024 MB, 1024 MB
11,google,node,1024,europe-west1,1972,1856,116,Google 1024 MB, 1024 MB
11,google,node,1024,europe-west1,2031,1818,213,Google 1024 MB, 1024 MB
11,google,node,1024,europe-west1,2016,1907,109,Google 1024 MB, 1024 MB
11,google,node,1024,europe-west1,2015,1909,106,Google 1024 MB, 1024 MB
11,google,node,1024,europe-west1,2079,1975,104,Google 1024 MB, 1024 MB
11,google,node,1024,europe-west1,2154,2042,112,Google 1024 MB, 1024 MB
11,google,node,1024,europe-west1,2220,1860,360,Google 1024 MB, 1024 MB
11,google,node,1024,europe-west1,2388,2285,103,Google 1024 MB, 1024 MB
11,google,node,1024,europe-west1,2240,1835,405,Google 1024 MB, 1024 MB
11,google,node,1024,europe-west1,2068,1903,165,Google 1024 MB, 1024 MB
11,google,node,1024,europe-west1,2176,1838,338,Google 1024 MB, 1024 MB
11,google,node,1024,europe-west1,2031,1867,164,Google 1024 MB, 1024 MB
11,google,node,1024,europe-west1,1978,1777,201,Google 1024 MB, 1024 MB
11,google,node,1024,europe-west1,2101,1896,205,Google 1024 MB, 1024 MB
11,google,node,1024,europe-west1,2039,1838,201,Google 1024 MB, 1024 MB
11,google,node,1024,europe-west1,2039,1841,198,Google 1024 MB, 1024 MB
11,google,node,1024,europe-west1,1968,1764,204,Google 1024 MB, 1024 MB
11,google,node,1024,europe-west1,1900,1799,101,Google 1024 MB, 1024 MB
11,google,node,1024,europe-west1,1868,1796,72,Google 1024 MB, 1024 MB
11,google,node,1024,europe-west1,2049,1797,252,Google 1024 MB, 1024 MB
11,google,node,1024,europe-west1,2347,1835,512,Google 1024 MB, 1024 MB
11,google,node,1024,europe-west1,1892,1824,68,Google 1024 MB, 1024 MB
11,google,node,1024,europe-west1,1848,1733,115,Google 1024 MB, 1024 MB
11,google,node,1024,europe-west1,2156,1809,347,Google 1024 MB, 1024 MB
11,google,node,1024,europe-west1,2059,1856,203,Google 1024 MB, 1024 MB
11,google,node,1024,europe-west1,1939,1830,109,Google 1024 MB, 1024 MB
11,google,node,1024,europe-west1,1882,1774,108,Google 1024 MB, 1024 MB
11,google,node,1024,europe-west1,2076,1869,207,Google 1024 MB, 1024 MB
11,google,node,1024,europe-west1,2517,1811,706,Google 1024 MB, 1024 MB
11,google,node,1024,europe-west1,1926,1795,131,Google 1024 MB, 1024 MB
11,google,node,1024,europe-west1,2027,1834,193,Google 1024 MB, 1024 MB
11,google,node,1024,europe-west1,1928,1828,100,Google 1024 MB, 1024 MB
11,google,node,1024,europe-west1,2024,1826,198,Google 1024 MB, 1024 MB
11,google,node,1024,europe-west1,1998,1744,254,Google 1024 MB, 1024 MB
11,google,node,1024,europe-west1,1936,1821,115,Google 1024 MB, 1024 MB
11,google,node,1024,europe-west1,2238,2126,112,Google 1024 MB, 1024 MB
11,google,node,1024,europe-west1,2085,1959,126,Google 1024 MB, 1024 MB
11,google,node,1024,europe-west1,1875,1685,190,Google 1024 MB, 1024 MB
11,google,node,1024,europe-west1,1901,1793,108,Google 1024 MB, 1024 MB
11,google,node,1024,europe-west1,1961,1764,197,Google 1024 MB, 1024 MB
11,google,node,1024,europe-west1,1850,1742,108,Google 1024 MB, 1024 MB
11,google,node,1024,europe-west1,2564,2368,196,Google 1024 MB, 1024 MB
11,google,node,1024,europe-west1,1862,1753,109,Google 1024 MB, 1024 MB
11,google,node,1024,europe-west1,1870,1756,114,Google 1024 MB, 1024 MB
11,google,node,1024,europe-west1,1928,1743,185,Google 1024 MB, 1024 MB
11,google,node,1024,europe-west1,1997,1809,188,Google 1024 MB, 1024 MB
11,google,node,1024,europe-west1,2082,2008,74,Google 1024 MB, 1024 MB
11,google,node,1024,europe-west1,2011,1829,182,Google 1024 MB, 1024 MB
11,google,node,1024,europe-west1,1893,1782,111,Google 1024 MB, 1024 MB
11,google,node,1024,europe-west1,1938,1741,197,Google 1024 MB, 1024 MB
11,google,node,1024,europe-west1,2304,1859,445,Google 1024 MB, 1024 MB
11,google,node,1024,europe-west1,1968,1827,141,Google 1024 MB, 1024 MB
11,google,node,1024,europe-west1,2314,1774,540,Google 1024 MB, 1024 MB
11,google,node,1024,europe-west1,2561,2268,293,Google 1024 MB, 1024 MB
11,google,node,1024,europe-west1,2056,1942,114,Google 1024 MB, 1024 MB
11,google,node,1024,europe-west1,1993,1929,64,Google 1024 MB, 1024 MB
12,google,node,2048,europe-west1,3260,3084,176,Google 2048 MB, 2048 MB
12,google,node,2048,europe-west1,1909,1751,158,Google 2048 MB, 2048 MB
12,google,node,2048,europe-west1,1811,1660,151,Google 2048 MB, 2048 MB
12,google,node,2048,europe-west1,1575,1469,106,Google 2048 MB, 2048 MB
12,google,node,2048,europe-west1,1638,1515,123,Google 2048 MB, 2048 MB
12,google,node,2048,europe-west1,1723,1629,94,Google 2048 MB, 2048 MB
12,google,node,2048,europe-west1,1676,1606,70,Google 2048 MB, 2048 MB
12,google,node,2048,europe-west1,1571,1513,58,Google 2048 MB, 2048 MB
12,google,node,2048,europe-west1,1619,1488,131,Google 2048 MB, 2048 MB
12,google,node,2048,europe-west1,1628,1551,77,Google 2048 MB, 2048 MB
12,google,node,2048,europe-west1,1647,1512,135,Google 2048 MB, 2048 MB
12,google,node,2048,europe-west1,1498,1425,73,Google 2048 MB, 2048 MB
12,google,node,2048,europe-west1,1686,1604,82,Google 2048 MB, 2048 MB
12,google,node,2048,europe-west1,2133,2006,127,Google 2048 MB, 2048 MB
12,google,node,2048,europe-west1,1630,1511,119,Google 2048 MB, 2048 MB
12,google,node,2048,europe-west1,1609,1546,63,Google 2048 MB, 2048 MB
12,google,node,2048,europe-west1,1667,1553,114,Google 2048 MB, 2048 MB
12,google,node,2048,europe-west1,1862,1751,111,Google 2048 MB, 2048 MB
12,google,node,2048,europe-west1,1868,1756,112,Google 2048 MB, 2048 MB
12,google,node,2048,europe-west1,2385,2029,356,Google 2048 MB, 2048 MB
12,google,node,2048,europe-west1,1727,1549,178,Google 2048 MB, 2048 MB
12,google,node,2048,europe-west1,1609,1544,65,Google 2048 MB, 2048 MB
12,google,node,2048,europe-west1,1589,1473,116,Google 2048 MB, 2048 MB
12,google,node,2048,europe-west1,1552,1477,75,Google 2048 MB, 2048 MB
12,google,node,2048,europe-west1,1427,1346,81,Google 2048 MB, 2048 MB
12,google,node,2048,europe-west1,1945,1731,214,Google 2048 MB, 2048 MB
12,google,node,2048,europe-west1,1527,1438,89,Google 2048 MB, 2048 MB
12,google,node,2048,europe-west1,1630,1522,108,Google 2048 MB, 2048 MB
12,google,node,2048,europe-west1,1600,1439,161,Google 2048 MB, 2048 MB
12,google,node,2048,europe-west1,1496,1428,68,Google 2048 MB, 2048 MB
12,google,node,2048,europe-west1,2059,1852,207,Google 2048 MB, 2048 MB
12,google,node,2048,europe-west1,1735,1537,198,Google 2048 MB, 2048 MB
12,google,node,2048,europe-west1,1613,1547,66,Google 2048 MB, 2048 MB
12,google,node,2048,europe-west1,1710,1566,144,Google 2048 MB, 2048 MB
12,google,node,2048,europe-west1,1832,1650,182,Google 2048 MB, 2048 MB
12,google,node,2048,europe-west1,1524,1459,65,Google 2048 MB, 2048 MB
12,google,node,2048,europe-west1,1562,1423,139,Google 2048 MB, 2048 MB
12,google,node,2048,europe-west1,1942,1760,182,Google 2048 MB, 2048 MB
12,google,node,2048,europe-west1,1651,1577,74,Google 2048 MB, 2048 MB
12,google,node,2048,europe-west1,1679,1546,133,Google 2048 MB, 2048 MB
12,google,node,2048,europe-west1,1587,1403,184,Google 2048 MB, 2048 MB
12,google,node,2048,europe-west1,1552,1489,63,Google 2048 MB, 2048 MB
12,google,node,2048,europe-west1,2638,2347,291,Google 2048 MB, 2048 MB
12,google,node,2048,europe-west1,5199,5028,171,Google 2048 MB, 2048 MB
12,google,node,2048,europe-west1,5926,5634,292,Google 2048 MB, 2048 MB
12,google,node,2048,europe-west1,5290,4294,996,Google 2048 MB, 2048 MB
12,google,node,2048,europe-west1,3053,1583,1470,Google 2048 MB, 2048 MB
12,google,node,2048,europe-west1,1673,1541,132,Google 2048 MB, 2048 MB
12,google,node,2048,europe-west1,1818,1677,141,Google 2048 MB, 2048 MB
12,google,node,2048,europe-west1,3300,3140,160,Google 2048 MB, 2048 MB
12,google,node,2048,europe-west1,1983,1847,136,Google 2048 MB, 2048 MB
12,google,node,2048,europe-west1,1572,1496,76,Google 2048 MB, 2048 MB
12,google,node,2048,europe-west1,1682,1542,140,Google 2048 MB, 2048 MB
12,google,node,2048,europe-west1,1699,1535,164,Google 2048 MB, 2048 MB
12,google,node,2048,europe-west1,1680,1608,72,Google 2048 MB, 2048 MB
12,google,node,2048,europe-west1,1656,1585,71,Google 2048 MB, 2048 MB
12,google,node,2048,europe-west1,1773,1560,213,Google 2048 MB, 2048 MB
12,google,node,2048,europe-west1,1764,1653,111,Google 2048 MB, 2048 MB
12,google,node,2048,europe-west1,1834,1630,204,Google 2048 MB, 2048 MB
12,google,node,2048,europe-west1,1815,1608,207,Google 2048 MB, 2048 MB
12,google,node,2048,europe-west1,1586,1521,65,Google 2048 MB, 2048 MB
12,google,node,2048,europe-west1,2365,1765,600,Google 2048 MB, 2048 MB
12,google,node,2048,europe-west1,1697,1552,145,Google 2048 MB, 2048 MB
12,google,node,2048,europe-west1,1803,1669,134,Google 2048 MB, 2048 MB
12,google,node,2048,europe-west1,1634,1443,191,Google 2048 MB, 2048 MB
12,google,node,2048,europe-west1,2250,2059,191,Google 2048 MB, 2048 MB
12,google,node,2048,europe-west1,1692,1628,64,Google 2048 MB, 2048 MB
12,google,node,2048,europe-west1,1728,1596,132,Google 2048 MB, 2048 MB
12,google,node,2048,europe-west1,1762,1640,122,Google 2048 MB, 2048 MB
12,google,node,2048,europe-west1,1821,1654,167,Google 2048 MB, 2048 MB
12,google,node,2048,europe-west1,1795,1630,165,Google 2048 MB, 2048 MB
12,google,node,2048,europe-west1,1977,1626,351,Google 2048 MB, 2048 MB
12,google,node,2048,europe-west1,1617,1497,120,Google 2048 MB, 2048 MB
12,google,node,2048,europe-west1,2726,2549,177,Google 2048 MB, 2048 MB
12,google,node,2048,europe-west1,2785,2608,177,Google 2048 MB, 2048 MB
12,google,node,2048,europe-west1,2085,1933,152,Google 2048 MB, 2048 MB
12,google,node,2048,europe-west1,1823,1620,203,Google 2048 MB, 2048 MB
12,google,node,2048,europe-west1,1785,1673,112,Google 2048 MB, 2048 MB
12,google,node,2048,europe-west1,1576,1513,63,Google 2048 MB, 2048 MB
12,google,node,2048,europe-west1,1654,1583,71,Google 2048 MB, 2048 MB
12,google,node,2048,europe-west1,1653,1563,90,Google 2048 MB, 2048 MB
12,google,node,2048,europe-west1,1601,1526,75,Google 2048 MB, 2048 MB
12,google,node,2048,europe-west1,1673,1592,81,Google 2048 MB, 2048 MB
12,google,node,2048,europe-west1,1635,1502,133,Google 2048 MB, 2048 MB
12,google,node,2048,europe-west1,1776,1659,117,Google 2048 MB, 2048 MB
12,google,node,2048,europe-west1,1848,1660,188,Google 2048 MB, 2048 MB
12,google,node,2048,europe-west1,1751,1636,115,Google 2048 MB, 2048 MB
12,google,node,2048,europe-west1,1995,1873,122,Google 2048 MB, 2048 MB
12,google,node,2048,europe-west1,1833,1705,128,Google 2048 MB, 2048 MB
12,google,node,2048,europe-west1,1691,1560,131,Google 2048 MB, 2048 MB
12,google,node,2048,europe-west1,1598,1485,113,Google 2048 MB, 2048 MB
12,google,node,2048,europe-west1,1676,1556,120,Google 2048 MB, 2048 MB
12,google,node,2048,europe-west1,1657,1532,125,Google 2048 MB, 2048 MB
12,google,node,2048,europe-west1,1781,1660,121,Google 2048 MB, 2048 MB
12,google,node,2048,europe-west1,1613,1494,119,Google 2048 MB, 2048 MB
12,google,node,2048,europe-west1,1804,1411,393,Google 2048 MB, 2048 MB
12,google,node,2048,europe-west1,1603,1498,105,Google 2048 MB, 2048 MB
12,google,node,2048,europe-west1,1583,1508,75,Google 2048 MB, 2048 MB
12,google,node,2048,europe-west1,1616,1505,111,Google 2048 MB, 2048 MB
12,google,node,2048,europe-west1,1592,1421,171,Google 2048 MB, 2048 MB
