cloud,runtime,memory_mb,region,total_ms,measured_ms,latency_ms,name
aws,node,128,eu-central-1,18296,18083,213,AWS 0128 MB
aws,node,128,eu-central-1,17545,17103,442,AWS 0128 MB
aws,node,128,eu-central-1,17453,17022,431,AWS 0128 MB
aws,node,128,eu-central-1,17364,16903,461,AWS 0128 MB
aws,node,128,eu-central-1,18576,18377,199,AWS 0128 MB
aws,node,128,eu-central-1,17018,16848,170,AWS 0128 MB
aws,node,128,eu-central-1,16882,16725,157,AWS 0128 MB
aws,node,128,eu-central-1,16752,16581,171,AWS 0128 MB
aws,node,128,eu-central-1,18765,18152,613,AWS 0128 MB
aws,node,128,eu-central-1,17063,16851,212,AWS 0128 MB
aws,node,128,eu-central-1,17197,17053,144,AWS 0128 MB
aws,node,128,eu-central-1,16918,16751,167,AWS 0128 MB
aws,node,128,eu-central-1,18287,18138,149,AWS 0128 MB
aws,node,128,eu-central-1,16797,16646,151,AWS 0128 MB
aws,node,128,eu-central-1,16975,16825,150,AWS 0128 MB
aws,node,128,eu-central-1,16657,16492,165,AWS 0128 MB
aws,node,128,eu-central-1,18217,18088,129,AWS 0128 MB
aws,node,128,eu-central-1,16997,16858,139,AWS 0128 MB
aws,node,128,eu-central-1,17081,16914,167,AWS 0128 MB
aws,node,128,eu-central-1,16839,16704,135,AWS 0128 MB
aws,node,128,eu-central-1,18284,18107,177,AWS 0128 MB
aws,node,128,eu-central-1,16774,16667,107,AWS 0128 MB
aws,node,128,eu-central-1,16941,16788,153,AWS 0128 MB
aws,node,128,eu-central-1,16659,16491,168,AWS 0128 MB
aws,node,128,eu-central-1,18241,18080,161,AWS 0128 MB
aws,node,128,eu-central-1,17125,16960,165,AWS 0128 MB
aws,node,128,eu-central-1,17007,16801,206,AWS 0128 MB
aws,node,128,eu-central-1,16636,16502,134,AWS 0128 MB
aws,node,128,eu-central-1,18452,18299,153,AWS 0128 MB
aws,node,128,eu-central-1,17000,16881,119,AWS 0128 MB
aws,node,128,eu-central-1,16957,16815,142,AWS 0128 MB
aws,node,128,eu-central-1,16851,16681,170,AWS 0128 MB
aws,node,128,eu-central-1,18059,17909,150,AWS 0128 MB
aws,node,128,eu-central-1,17071,16926,145,AWS 0128 MB
aws,node,128,eu-central-1,16933,16787,146,AWS 0128 MB
aws,node,128,eu-central-1,17065,16686,379,AWS 0128 MB
aws,node,128,eu-central-1,18278,18101,177,AWS 0128 MB
aws,node,128,eu-central-1,17085,16930,155,AWS 0128 MB
aws,node,128,eu-central-1,16871,16668,203,AWS 0128 MB
aws,node,128,eu-central-1,16773,16649,124,AWS 0128 MB
aws,node,128,eu-central-1,18239,18086,153,AWS 0128 MB
aws,node,128,eu-central-1,16764,16613,151,AWS 0128 MB
aws,node,128,eu-central-1,17012,16869,143,AWS 0128 MB
aws,node,128,eu-central-1,16812,16681,131,AWS 0128 MB
aws,node,128,eu-central-1,18286,18105,181,AWS 0128 MB
aws,node,128,eu-central-1,16753,16573,180,AWS 0128 MB
aws,node,128,eu-central-1,17058,16905,153,AWS 0128 MB
aws,node,128,eu-central-1,16703,16560,143,AWS 0128 MB
aws,node,128,eu-central-1,18259,18062,197,AWS 0128 MB
aws,node,128,eu-central-1,16786,16613,173,AWS 0128 MB
aws,node,128,eu-central-1,17130,16969,161,AWS 0128 MB
aws,node,128,eu-central-1,16625,16489,136,AWS 0128 MB
aws,node,128,eu-central-1,18482,18314,168,AWS 0128 MB
aws,node,128,eu-central-1,17173,16926,247,AWS 0128 MB
aws,node,128,eu-central-1,17076,16927,149,AWS 0128 MB
aws,node,128,eu-central-1,16618,16454,164,AWS 0128 MB
aws,node,128,eu-central-1,18131,17988,143,AWS 0128 MB
aws,node,128,eu-central-1,17133,16964,169,AWS 0128 MB
aws,node,128,eu-central-1,17025,16865,160,AWS 0128 MB
aws,node,128,eu-central-1,16770,16630,140,AWS 0128 MB
aws,node,128,eu-central-1,18370,18173,197,AWS 0128 MB
aws,node,128,eu-central-1,16969,16800,169,AWS 0128 MB
aws,node,128,eu-central-1,16878,16696,182,AWS 0128 MB
aws,node,128,eu-central-1,16766,16643,123,AWS 0128 MB
aws,node,128,eu-central-1,18202,18060,142,AWS 0128 MB
aws,node,128,eu-central-1,17051,16855,196,AWS 0128 MB
aws,node,128,eu-central-1,16918,16732,186,AWS 0128 MB
aws,node,128,eu-central-1,16745,16573,172,AWS 0128 MB
aws,node,128,eu-central-1,18359,18212,147,AWS 0128 MB
aws,node,128,eu-central-1,17184,17037,147,AWS 0128 MB
aws,node,128,eu-central-1,16976,16810,166,AWS 0128 MB
aws,node,128,eu-central-1,16717,16577,140,AWS 0128 MB
aws,node,128,eu-central-1,17418,17297,121,AWS 0128 MB
aws,node,128,eu-central-1,16966,16766,200,AWS 0128 MB
aws,node,128,eu-central-1,16873,16710,163,AWS 0128 MB
aws,node,128,eu-central-1,16636,16480,156,AWS 0128 MB
aws,node,128,eu-central-1,17411,17271,140,AWS 0128 MB
aws,node,128,eu-central-1,16833,16689,144,AWS 0128 MB
aws,node,128,eu-central-1,17044,16913,131,AWS 0128 MB
aws,node,128,eu-central-1,16894,16755,139,AWS 0128 MB
aws,node,128,eu-central-1,17581,17100,481,AWS 0128 MB
aws,node,128,eu-central-1,16864,16629,235,AWS 0128 MB
aws,node,128,eu-central-1,16979,16818,161,AWS 0128 MB
aws,node,128,eu-central-1,16816,16699,117,AWS 0128 MB
aws,node,128,eu-central-1,17473,17331,142,AWS 0128 MB
aws,node,128,eu-central-1,16798,16677,121,AWS 0128 MB
aws,node,128,eu-central-1,16908,16757,151,AWS 0128 MB
aws,node,128,eu-central-1,16831,16674,157,AWS 0128 MB
aws,node,128,eu-central-1,17369,17230,139,AWS 0128 MB
aws,node,128,eu-central-1,16851,16668,183,AWS 0128 MB
aws,node,128,eu-central-1,16784,16646,138,AWS 0128 MB
aws,node,128,eu-central-1,16917,16765,152,AWS 0128 MB
aws,node,128,eu-central-1,17398,17258,140,AWS 0128 MB
aws,node,128,eu-central-1,17041,16887,154,AWS 0128 MB
aws,node,128,eu-central-1,16976,16750,226,AWS 0128 MB
aws,node,128,eu-central-1,16676,16549,127,AWS 0128 MB
aws,node,128,eu-central-1,17324,17161,163,AWS 0128 MB
aws,node,128,eu-central-1,16964,16772,192,AWS 0128 MB
aws,node,128,eu-central-1,16883,16722,161,AWS 0128 MB
aws,node,128,eu-central-1,16725,16567,158,AWS 0128 MB
aws,node,256,eu-central-1,9443,9264,179,AWS 0256 MB
aws,node,256,eu-central-1,8779,8418,361,AWS 0256 MB
aws,node,256,eu-central-1,9264,9129,135,AWS 0256 MB
aws,node,256,eu-central-1,8488,8361,127,AWS 0256 MB
aws,node,256,eu-central-1,9335,9195,140,AWS 0256 MB
aws,node,256,eu-central-1,8382,8272,110,AWS 0256 MB
aws,node,256,eu-central-1,9171,9039,132,AWS 0256 MB
aws,node,256,eu-central-1,8517,8367,150,AWS 0256 MB
aws,node,256,eu-central-1,9390,9245,145,AWS 0256 MB
aws,node,256,eu-central-1,8319,8201,118,AWS 0256 MB
aws,node,256,eu-central-1,9385,9273,112,AWS 0256 MB
aws,node,256,eu-central-1,8456,8326,130,AWS 0256 MB
aws,node,256,eu-central-1,9244,9095,149,AWS 0256 MB
aws,node,256,eu-central-1,8373,8222,151,AWS 0256 MB
aws,node,256,eu-central-1,9365,9234,131,AWS 0256 MB
aws,node,256,eu-central-1,8390,8260,130,AWS 0256 MB
aws,node,256,eu-central-1,9657,9210,447,AWS 0256 MB
aws,node,256,eu-central-1,8787,8329,458,AWS 0256 MB
aws,node,256,eu-central-1,9309,9159,150,AWS 0256 MB
aws,node,256,eu-central-1,8497,8370,127,AWS 0256 MB
aws,node,256,eu-central-1,9382,9243,139,AWS 0256 MB
aws,node,256,eu-central-1,8547,8258,289,AWS 0256 MB
aws,node,256,eu-central-1,9238,9094,144,AWS 0256 MB
aws,node,256,eu-central-1,8478,8337,141,AWS 0256 MB
aws,node,256,eu-central-1,9387,9257,130,AWS 0256 MB
aws,node,256,eu-central-1,8517,8361,156,AWS 0256 MB
aws,node,256,eu-central-1,9294,9142,152,AWS 0256 MB
aws,node,256,eu-central-1,8500,8337,163,AWS 0256 MB
aws,node,256,eu-central-1,9347,9240,107,AWS 0256 MB
aws,node,256,eu-central-1,8439,8340,99,AWS 0256 MB
aws,node,256,eu-central-1,9521,9127,394,AWS 0256 MB
aws,node,256,eu-central-1,8350,8209,141,AWS 0256 MB
aws,node,256,eu-central-1,9382,9260,122,AWS 0256 MB
aws,node,256,eu-central-1,8374,8255,119,AWS 0256 MB
aws,node,256,eu-central-1,9178,9080,98,AWS 0256 MB
aws,node,256,eu-central-1,8794,8324,470,AWS 0256 MB
aws,node,256,eu-central-1,9409,9289,120,AWS 0256 MB
aws,node,256,eu-central-1,8340,8199,141,AWS 0256 MB
aws,node,256,eu-central-1,9232,9056,176,AWS 0256 MB
aws,node,256,eu-central-1,8458,8314,144,AWS 0256 MB
aws,node,256,eu-central-1,9415,9298,117,AWS 0256 MB
aws,node,256,eu-central-1,8367,8232,135,AWS 0256 MB
aws,node,256,eu-central-1,9200,9062,138,AWS 0256 MB
aws,node,256,eu-central-1,8399,8254,145,AWS 0256 MB
aws,node,256,eu-central-1,9414,9277,137,AWS 0256 MB
aws,node,256,eu-central-1,8357,8234,123,AWS 0256 MB
aws,node,256,eu-central-1,9347,9181,166,AWS 0256 MB
aws,node,256,eu-central-1,8416,8274,142,AWS 0256 MB
aws,node,256,eu-central-1,9286,9165,121,AWS 0256 MB
aws,node,256,eu-central-1,8376,8227,149,AWS 0256 MB
aws,node,256,eu-central-1,9185,9066,119,AWS 0256 MB
aws,node,256,eu-central-1,8329,8211,118,AWS 0256 MB
aws,node,256,eu-central-1,9303,9181,122,AWS 0256 MB
aws,node,256,eu-central-1,8376,8248,128,AWS 0256 MB
aws,node,256,eu-central-1,9299,9150,149,AWS 0256 MB
aws,node,256,eu-central-1,8470,8348,122,AWS 0256 MB
aws,node,256,eu-central-1,9425,9286,139,AWS 0256 MB
aws,node,256,eu-central-1,8471,8331,140,AWS 0256 MB
aws,node,256,eu-central-1,9301,9175,126,AWS 0256 MB
aws,node,256,eu-central-1,8477,8326,151,AWS 0256 MB
aws,node,256,eu-central-1,9361,9239,122,AWS 0256 MB
aws,node,256,eu-central-1,8375,8247,128,AWS 0256 MB
aws,node,256,eu-central-1,9320,9171,149,AWS 0256 MB
aws,node,256,eu-central-1,8420,8276,144,AWS 0256 MB
aws,node,256,eu-central-1,9287,9147,140,AWS 0256 MB
aws,node,256,eu-central-1,8451,8238,213,AWS 0256 MB
aws,node,256,eu-central-1,9169,9049,120,AWS 0256 MB
aws,node,256,eu-central-1,8516,8377,139,AWS 0256 MB
aws,node,256,eu-central-1,9344,9204,140,AWS 0256 MB
aws,node,256,eu-central-1,8451,8341,110,AWS 0256 MB
aws,node,256,eu-central-1,9221,9085,136,AWS 0256 MB
aws,node,256,eu-central-1,8489,8341,148,AWS 0256 MB
aws,node,256,eu-central-1,9254,9113,141,AWS 0256 MB
aws,node,256,eu-central-1,8479,8332,147,AWS 0256 MB
aws,node,256,eu-central-1,9174,9033,141,AWS 0256 MB
aws,node,256,eu-central-1,8418,8302,116,AWS 0256 MB
aws,node,256,eu-central-1,9251,9133,118,AWS 0256 MB
aws,node,256,eu-central-1,8337,8208,129,AWS 0256 MB
aws,node,256,eu-central-1,9189,9055,134,AWS 0256 MB
aws,node,256,eu-central-1,8375,8248,127,AWS 0256 MB
aws,node,256,eu-central-1,9289,9177,112,AWS 0256 MB
aws,node,256,eu-central-1,8480,8335,145,AWS 0256 MB
aws,node,256,eu-central-1,9193,9069,124,AWS 0256 MB
aws,node,256,eu-central-1,8390,8291,99,AWS 0256 MB
aws,node,256,eu-central-1,8903,8773,130,AWS 0256 MB
aws,node,256,eu-central-1,8366,8230,136,AWS 0256 MB
aws,node,256,eu-central-1,8816,8688,128,AWS 0256 MB
aws,node,256,eu-central-1,8549,8434,115,AWS 0256 MB
aws,node,256,eu-central-1,8836,8685,151,AWS 0256 MB
aws,node,256,eu-central-1,8467,8332,135,AWS 0256 MB
aws,node,256,eu-central-1,8913,8779,134,AWS 0256 MB
aws,node,256,eu-central-1,8500,8355,145,AWS 0256 MB
aws,node,256,eu-central-1,8816,8670,146,AWS 0256 MB
aws,node,256,eu-central-1,8419,8270,149,AWS 0256 MB
aws,node,256,eu-central-1,8906,8788,118,AWS 0256 MB
aws,node,256,eu-central-1,8459,8307,152,AWS 0256 MB
aws,node,256,eu-central-1,8845,8729,116,AWS 0256 MB
aws,node,256,eu-central-1,8473,8335,138,AWS 0256 MB
aws,node,256,eu-central-1,8925,8696,229,AWS 0256 MB
aws,node,256,eu-central-1,8503,8378,125,AWS 0256 MB
aws,node,512,eu-central-1,4719,4569,150,AWS 0512 MB
aws,node,512,eu-central-1,4581,4459,122,AWS 0512 MB
aws,node,512,eu-central-1,4641,4515,126,AWS 0512 MB
aws,node,512,eu-central-1,4563,4453,110,AWS 0512 MB
aws,node,512,eu-central-1,4608,4505,103,AWS 0512 MB
aws,node,512,eu-central-1,4620,4498,122,AWS 0512 MB
aws,node,512,eu-central-1,4561,4444,117,AWS 0512 MB
aws,node,512,eu-central-1,4606,4504,102,AWS 0512 MB
aws,node,512,eu-central-1,4557,4460,97,AWS 0512 MB
aws,node,512,eu-central-1,4668,4495,173,AWS 0512 MB
aws,node,512,eu-central-1,4598,4499,99,AWS 0512 MB
aws,node,512,eu-central-1,4609,4501,108,AWS 0512 MB
aws,node,512,eu-central-1,4589,4440,149,AWS 0512 MB
aws,node,512,eu-central-1,4615,4511,104,AWS 0512 MB
aws,node,512,eu-central-1,4556,4457,99,AWS 0512 MB
aws,node,512,eu-central-1,4615,4509,106,AWS 0512 MB
aws,node,512,eu-central-1,4527,4422,105,AWS 0512 MB
aws,node,512,eu-central-1,4645,4514,131,AWS 0512 MB
aws,node,512,eu-central-1,4619,4476,143,AWS 0512 MB
aws,node,512,eu-central-1,5066,4519,547,AWS 0512 MB
aws,node,512,eu-central-1,4544,4440,104,AWS 0512 MB
aws,node,512,eu-central-1,4636,4499,137,AWS 0512 MB
aws,node,512,eu-central-1,4538,4412,126,AWS 0512 MB
aws,node,512,eu-central-1,4620,4512,108,AWS 0512 MB
aws,node,512,eu-central-1,4582,4468,114,AWS 0512 MB
aws,node,512,eu-central-1,4606,4492,114,AWS 0512 MB
aws,node,512,eu-central-1,4558,4444,114,AWS 0512 MB
aws,node,512,eu-central-1,4631,4490,141,AWS 0512 MB
aws,node,512,eu-central-1,4574,4470,104,AWS 0512 MB
aws,node,512,eu-central-1,4667,4474,193,AWS 0512 MB
aws,node,512,eu-central-1,4569,4443,126,AWS 0512 MB
aws,node,512,eu-central-1,4571,4456,115,AWS 0512 MB
aws,node,512,eu-central-1,4606,4491,115,AWS 0512 MB
aws,node,512,eu-central-1,4570,4458,112,AWS 0512 MB
aws,node,512,eu-central-1,4588,4473,115,AWS 0512 MB
aws,node,512,eu-central-1,4527,4432,95,AWS 0512 MB
aws,node,512,eu-central-1,4606,4487,119,AWS 0512 MB
aws,node,512,eu-central-1,4579,4448,131,AWS 0512 MB
aws,node,512,eu-central-1,4623,4505,118,AWS 0512 MB
aws,node,512,eu-central-1,4579,4452,127,AWS 0512 MB
aws,node,512,eu-central-1,4622,4518,104,AWS 0512 MB
aws,node,512,eu-central-1,4557,4444,113,AWS 0512 MB
aws,node,512,eu-central-1,4438,4314,124,AWS 0512 MB
aws,node,512,eu-central-1,4382,4249,133,AWS 0512 MB
aws,node,512,eu-central-1,4442,4323,119,AWS 0512 MB
aws,node,512,eu-central-1,4374,4243,131,AWS 0512 MB
aws,node,512,eu-central-1,4412,4292,120,AWS 0512 MB
aws,node,512,eu-central-1,4388,4255,133,AWS 0512 MB
aws,node,512,eu-central-1,4445,4318,127,AWS 0512 MB
aws,node,512,eu-central-1,4413,4306,107,AWS 0512 MB
aws,node,512,eu-central-1,4363,4233,130,AWS 0512 MB
aws,node,512,eu-central-1,4404,4298,106,AWS 0512 MB
aws,node,512,eu-central-1,4509,4252,257,AWS 0512 MB
aws,node,512,eu-central-1,4429,4306,123,AWS 0512 MB
aws,node,512,eu-central-1,4365,4257,108,AWS 0512 MB
aws,node,512,eu-central-1,4423,4310,113,AWS 0512 MB
aws,node,512,eu-central-1,4577,4273,304,AWS 0512 MB
aws,node,512,eu-central-1,4423,4325,98,AWS 0512 MB
aws,node,512,eu-central-1,4544,4244,300,AWS 0512 MB
aws,node,512,eu-central-1,4439,4291,148,AWS 0512 MB
aws,node,512,eu-central-1,4417,4270,147,AWS 0512 MB
aws,node,512,eu-central-1,4890,4321,569,AWS 0512 MB
aws,node,512,eu-central-1,4388,4260,128,AWS 0512 MB
aws,node,512,eu-central-1,4428,4309,119,AWS 0512 MB
aws,node,512,eu-central-1,4387,4271,116,AWS 0512 MB
aws,node,512,eu-central-1,4441,4305,136,AWS 0512 MB
aws,node,512,eu-central-1,4377,4267,110,AWS 0512 MB
aws,node,512,eu-central-1,4413,4306,107,AWS 0512 MB
aws,node,512,eu-central-1,4391,4276,115,AWS 0512 MB
aws,node,512,eu-central-1,4408,4312,96,AWS 0512 MB
aws,node,512,eu-central-1,4347,4239,108,AWS 0512 MB
aws,node,512,eu-central-1,4369,4257,112,AWS 0512 MB
aws,node,512,eu-central-1,4634,4314,320,AWS 0512 MB
aws,node,512,eu-central-1,4373,4246,127,AWS 0512 MB
aws,node,512,eu-central-1,4441,4339,102,AWS 0512 MB
aws,node,512,eu-central-1,4379,4267,112,AWS 0512 MB
aws,node,512,eu-central-1,4447,4315,132,AWS 0512 MB
aws,node,512,eu-central-1,4362,4263,99,AWS 0512 MB
aws,node,512,eu-central-1,4872,4324,548,AWS 0512 MB
aws,node,512,eu-central-1,4383,4266,117,AWS 0512 MB
aws,node,512,eu-central-1,4712,4309,403,AWS 0512 MB
aws,node,512,eu-central-1,4432,4330,102,AWS 0512 MB
aws,node,512,eu-central-1,4393,4270,123,AWS 0512 MB
aws,node,512,eu-central-1,4432,4307,125,AWS 0512 MB
aws,node,512,eu-central-1,4372,4249,123,AWS 0512 MB
aws,node,512,eu-central-1,4430,4319,111,AWS 0512 MB
aws,node,512,eu-central-1,4374,4274,100,AWS 0512 MB
aws,node,512,eu-central-1,4407,4304,103,AWS 0512 MB
aws,node,512,eu-central-1,4764,4237,527,AWS 0512 MB
aws,node,512,eu-central-1,4369,4253,116,AWS 0512 MB
aws,node,512,eu-central-1,4423,4306,117,AWS 0512 MB
aws,node,512,eu-central-1,4364,4248,116,AWS 0512 MB
aws,node,512,eu-central-1,4467,4324,143,AWS 0512 MB
aws,node,512,eu-central-1,4406,4312,94,AWS 0512 MB
aws,node,512,eu-central-1,4427,4309,118,AWS 0512 MB
aws,node,512,eu-central-1,4379,4267,112,AWS 0512 MB
aws,node,512,eu-central-1,4449,4343,106,AWS 0512 MB
aws,node,512,eu-central-1,4425,4303,122,AWS 0512 MB
aws,node,512,eu-central-1,4427,4327,100,AWS 0512 MB
aws,node,512,eu-central-1,4400,4283,117,AWS 0512 MB
aws,node,1024,eu-central-1,2510,2116,394,AWS 1024 MB
aws,node,1024,eu-central-1,2200,2079,121,AWS 1024 MB
aws,node,1024,eu-central-1,2184,2085,99,AWS 1024 MB
aws,node,1024,eu-central-1,2196,2069,127,AWS 1024 MB
aws,node,1024,eu-central-1,2218,2104,114,AWS 1024 MB
aws,node,1024,eu-central-1,2220,2103,117,AWS 1024 MB
aws,node,1024,eu-central-1,2261,2078,183,AWS 1024 MB
aws,node,1024,eu-central-1,2196,2088,108,AWS 1024 MB
aws,node,1024,eu-central-1,2175,2075,100,AWS 1024 MB
aws,node,1024,eu-central-1,2192,2062,130,AWS 1024 MB
aws,node,1024,eu-central-1,2210,2095,115,AWS 1024 MB
aws,node,1024,eu-central-1,2171,2063,108,AWS 1024 MB
aws,node,1024,eu-central-1,2229,2090,139,AWS 1024 MB
aws,node,1024,eu-central-1,2219,2082,137,AWS 1024 MB
aws,node,1024,eu-central-1,2216,2095,121,AWS 1024 MB
aws,node,1024,eu-central-1,2199,2081,118,AWS 1024 MB
aws,node,1024,eu-central-1,2197,2096,101,AWS 1024 MB
aws,node,1024,eu-central-1,2207,2070,137,AWS 1024 MB
aws,node,1024,eu-central-1,2216,2117,99,AWS 1024 MB
aws,node,1024,eu-central-1,2219,2084,135,AWS 1024 MB
aws,node,1024,eu-central-1,2221,2107,114,AWS 1024 MB
aws,node,1024,eu-central-1,2185,2081,104,AWS 1024 MB
aws,node,1024,eu-central-1,2216,2098,118,AWS 1024 MB
aws,node,1024,eu-central-1,2198,2080,118,AWS 1024 MB
aws,node,1024,eu-central-1,2216,2103,113,AWS 1024 MB
aws,node,1024,eu-central-1,2222,2085,137,AWS 1024 MB
aws,node,1024,eu-central-1,2211,2092,119,AWS 1024 MB
aws,node,1024,eu-central-1,2231,2118,113,AWS 1024 MB
aws,node,1024,eu-central-1,2609,2070,539,AWS 1024 MB
aws,node,1024,eu-central-1,2209,2098,111,AWS 1024 MB
aws,node,1024,eu-central-1,2194,2075,119,AWS 1024 MB
aws,node,1024,eu-central-1,2219,2108,111,AWS 1024 MB
aws,node,1024,eu-central-1,2203,2073,130,AWS 1024 MB
aws,node,1024,eu-central-1,2215,2104,111,AWS 1024 MB
aws,node,1024,eu-central-1,2199,2086,113,AWS 1024 MB
aws,node,1024,eu-central-1,2240,2109,131,AWS 1024 MB
aws,node,1024,eu-central-1,2187,2075,112,AWS 1024 MB
aws,node,1024,eu-central-1,2195,2099,96,AWS 1024 MB
aws,node,1024,eu-central-1,2544,2078,466,AWS 1024 MB
aws,node,1024,eu-central-1,2228,2099,129,AWS 1024 MB
aws,node,1024,eu-central-1,2172,2065,107,AWS 1024 MB
aws,node,1024,eu-central-1,2205,2095,110,AWS 1024 MB
aws,node,1024,eu-central-1,2167,2064,103,AWS 1024 MB
aws,node,1024,eu-central-1,2196,2085,111,AWS 1024 MB
aws,node,1024,eu-central-1,2183,2064,119,AWS 1024 MB
aws,node,1024,eu-central-1,2205,2093,112,AWS 1024 MB
aws,node,1024,eu-central-1,2178,2056,122,AWS 1024 MB
aws,node,1024,eu-central-1,2204,2092,112,AWS 1024 MB
aws,node,1024,eu-central-1,2179,2065,114,AWS 1024 MB
aws,node,1024,eu-central-1,2189,2070,119,AWS 1024 MB
aws,node,1024,eu-central-1,2396,2059,337,AWS 1024 MB
aws,node,1024,eu-central-1,2177,2080,97,AWS 1024 MB
aws,node,1024,eu-central-1,2381,2045,336,AWS 1024 MB
aws,node,1024,eu-central-1,2197,2075,122,AWS 1024 MB
aws,node,1024,eu-central-1,2679,2059,620,AWS 1024 MB
aws,node,1024,eu-central-1,2195,2077,118,AWS 1024 MB
aws,node,1024,eu-central-1,2152,2053,99,AWS 1024 MB
aws,node,1024,eu-central-1,2193,2070,123,AWS 1024 MB
aws,node,1024,eu-central-1,2172,2060,112,AWS 1024 MB
aws,node,1024,eu-central-1,2177,2065,112,AWS 1024 MB
aws,node,1024,eu-central-1,2178,2052,126,AWS 1024 MB
aws,node,1024,eu-central-1,2187,2062,125,AWS 1024 MB
aws,node,1024,eu-central-1,2193,2068,125,AWS 1024 MB
aws,node,1024,eu-central-1,2181,2070,111,AWS 1024 MB
aws,node,1024,eu-central-1,2347,2065,282,AWS 1024 MB
aws,node,1024,eu-central-1,2199,2072,127,AWS 1024 MB
aws,node,1024,eu-central-1,2177,2061,116,AWS 1024 MB
aws,node,1024,eu-central-1,2185,2065,120,AWS 1024 MB
aws,node,1024,eu-central-1,2198,2076,122,AWS 1024 MB
aws,node,1024,eu-central-1,2162,2055,107,AWS 1024 MB
aws,node,1024,eu-central-1,2213,2080,133,AWS 1024 MB
aws,node,1024,eu-central-1,2181,2060,121,AWS 1024 MB
aws,node,1024,eu-central-1,2662,2077,585,AWS 1024 MB
aws,node,1024,eu-central-1,2193,2068,125,AWS 1024 MB
aws,node,1024,eu-central-1,2202,2086,116,AWS 1024 MB
aws,node,1024,eu-central-1,2191,2069,122,AWS 1024 MB
aws,node,1024,eu-central-1,2175,2076,99,AWS 1024 MB
aws,node,1024,eu-central-1,2180,2056,124,AWS 1024 MB
aws,node,1024,eu-central-1,2191,2079,112,AWS 1024 MB
aws,node,1024,eu-central-1,2168,2063,105,AWS 1024 MB
aws,node,1024,eu-central-1,2206,2086,120,AWS 1024 MB
aws,node,1024,eu-central-1,2188,2070,118,AWS 1024 MB
aws,node,1024,eu-central-1,2212,2088,124,AWS 1024 MB
aws,node,1024,eu-central-1,2169,2067,102,AWS 1024 MB
aws,node,1024,eu-central-1,2206,2087,119,AWS 1024 MB
aws,node,1024,eu-central-1,2183,2064,119,AWS 1024 MB
aws,node,1024,eu-central-1,2203,2088,115,AWS 1024 MB
aws,node,1024,eu-central-1,2170,2063,107,AWS 1024 MB
aws,node,1024,eu-central-1,2651,2096,555,AWS 1024 MB
aws,node,1024,eu-central-1,2177,2066,111,AWS 1024 MB
aws,node,1024,eu-central-1,2214,2089,125,AWS 1024 MB
aws,node,1024,eu-central-1,2176,2061,115,AWS 1024 MB
aws,node,1024,eu-central-1,2517,2080,437,AWS 1024 MB
aws,node,1024,eu-central-1,2603,2068,535,AWS 1024 MB
aws,node,1024,eu-central-1,2304,2086,218,AWS 1024 MB
aws,node,1024,eu-central-1,2178,2065,113,AWS 1024 MB
aws,node,1024,eu-central-1,2314,2088,226,AWS 1024 MB
aws,node,1024,eu-central-1,2346,2069,277,AWS 1024 MB
aws,node,1024,eu-central-1,2344,2051,293,AWS 1024 MB
aws,node,1024,eu-central-1,2206,2090,116,AWS 1024 MB
aws,node,2048,eu-central-1,1224,1132,92,AWS 2048 MB
aws,node,2048,eu-central-1,1253,1127,126,AWS 2048 MB
aws,node,2048,eu-central-1,1243,1144,99,AWS 2048 MB
aws,node,2048,eu-central-1,1195,1124,71,AWS 2048 MB
aws,node,2048,eu-central-1,1239,1132,107,AWS 2048 MB
aws,node,2048,eu-central-1,1228,1147,81,AWS 2048 MB
aws,node,2048,eu-central-1,1179,1120,59,AWS 2048 MB
aws,node,2048,eu-central-1,1198,1119,79,AWS 2048 MB
aws,node,2048,eu-central-1,1199,1122,77,AWS 2048 MB
aws,node,2048,eu-central-1,1233,1166,67,AWS 2048 MB
aws,node,2048,eu-central-1,1235,1124,111,AWS 2048 MB
aws,node,2048,eu-central-1,1202,1135,67,AWS 2048 MB
aws,node,2048,eu-central-1,1265,1169,96,AWS 2048 MB
aws,node,2048,eu-central-1,1206,1132,74,AWS 2048 MB
aws,node,2048,eu-central-1,1239,1163,76,AWS 2048 MB
aws,node,2048,eu-central-1,1215,1137,78,AWS 2048 MB
aws,node,2048,eu-central-1,1241,1124,117,AWS 2048 MB
aws,node,2048,eu-central-1,1195,1124,71,AWS 2048 MB
aws,node,2048,eu-central-1,1202,1130,72,AWS 2048 MB
aws,node,2048,eu-central-1,1214,1131,83,AWS 2048 MB
aws,node,2048,eu-central-1,1237,1145,92,AWS 2048 MB
aws,node,2048,eu-central-1,1189,1133,56,AWS 2048 MB
aws,node,2048,eu-central-1,1197,1125,72,AWS 2048 MB
aws,node,2048,eu-central-1,1182,1124,58,AWS 2048 MB
aws,node,2048,eu-central-1,1210,1130,80,AWS 2048 MB
aws,node,2048,eu-central-1,1214,1141,73,AWS 2048 MB
aws,node,2048,eu-central-1,1195,1124,71,AWS 2048 MB
aws,node,2048,eu-central-1,1230,1125,105,AWS 2048 MB
aws,node,2048,eu-central-1,1211,1153,58,AWS 2048 MB
aws,node,2048,eu-central-1,1190,1116,74,AWS 2048 MB
aws,node,2048,eu-central-1,1238,1123,115,AWS 2048 MB
aws,node,2048,eu-central-1,1259,1146,113,AWS 2048 MB
aws,node,2048,eu-central-1,1228,1144,84,AWS 2048 MB
aws,node,2048,eu-central-1,1271,1195,76,AWS 2048 MB
aws,node,2048,eu-central-1,1229,1124,105,AWS 2048 MB
aws,node,2048,eu-central-1,1214,1141,73,AWS 2048 MB
aws,node,2048,eu-central-1,1216,1142,74,AWS 2048 MB
aws,node,2048,eu-central-1,1193,1127,66,AWS 2048 MB
aws,node,2048,eu-central-1,1206,1137,69,AWS 2048 MB
aws,node,2048,eu-central-1,1216,1135,81,AWS 2048 MB
aws,node,2048,eu-central-1,1204,1139,65,AWS 2048 MB
aws,node,2048,eu-central-1,1187,1128,59,AWS 2048 MB
aws,node,2048,eu-central-1,1179,1125,54,AWS 2048 MB
aws,node,2048,eu-central-1,1257,1135,122,AWS 2048 MB
aws,node,2048,eu-central-1,1197,1123,74,AWS 2048 MB
aws,node,2048,eu-central-1,1217,1138,79,AWS 2048 MB
aws,node,2048,eu-central-1,1183,1126,57,AWS 2048 MB
aws,node,2048,eu-central-1,1255,1136,119,AWS 2048 MB
aws,node,2048,eu-central-1,1191,1120,71,AWS 2048 MB
aws,node,2048,eu-central-1,1221,1131,90,AWS 2048 MB
aws,node,2048,eu-central-1,1192,1135,57,AWS 2048 MB
aws,node,2048,eu-central-1,1564,1130,434,AWS 2048 MB
aws,node,2048,eu-central-1,1255,1139,116,AWS 2048 MB
aws,node,2048,eu-central-1,1202,1124,78,AWS 2048 MB
aws,node,2048,eu-central-1,1196,1135,61,AWS 2048 MB
aws,node,2048,eu-central-1,1197,1136,61,AWS 2048 MB
aws,node,2048,eu-central-1,1224,1131,93,AWS 2048 MB
aws,node,2048,eu-central-1,1194,1138,56,AWS 2048 MB
aws,node,2048,eu-central-1,1193,1126,67,AWS 2048 MB
aws,node,2048,eu-central-1,1192,1137,55,AWS 2048 MB
aws,node,2048,eu-central-1,1197,1125,72,AWS 2048 MB
aws,node,2048,eu-central-1,1711,1150,561,AWS 2048 MB
aws,node,2048,eu-central-1,1196,1131,65,AWS 2048 MB
aws,node,2048,eu-central-1,1215,1136,79,AWS 2048 MB
aws,node,2048,eu-central-1,1196,1126,70,AWS 2048 MB
aws,node,2048,eu-central-1,1196,1132,64,AWS 2048 MB
aws,node,2048,eu-central-1,1218,1149,69,AWS 2048 MB
aws,node,2048,eu-central-1,1210,1137,73,AWS 2048 MB
aws,node,2048,eu-central-1,1198,1125,73,AWS 2048 MB
aws,node,2048,eu-central-1,1211,1134,77,AWS 2048 MB
aws,node,2048,eu-central-1,1256,1143,113,AWS 2048 MB
aws,node,2048,eu-central-1,1208,1133,75,AWS 2048 MB
aws,node,2048,eu-central-1,1240,1128,112,AWS 2048 MB
aws,node,2048,eu-central-1,1216,1139,77,AWS 2048 MB
aws,node,2048,eu-central-1,1225,1125,100,AWS 2048 MB
aws,node,2048,eu-central-1,1215,1138,77,AWS 2048 MB
aws,node,2048,eu-central-1,1190,1122,68,AWS 2048 MB
aws,node,2048,eu-central-1,1197,1135,62,AWS 2048 MB
aws,node,2048,eu-central-1,1196,1140,56,AWS 2048 MB
aws,node,2048,eu-central-1,1189,1134,55,AWS 2048 MB
aws,node,2048,eu-central-1,1198,1121,77,AWS 2048 MB
aws,node,2048,eu-central-1,1206,1133,73,AWS 2048 MB
aws,node,2048,eu-central-1,1188,1118,70,AWS 2048 MB
aws,node,2048,eu-central-1,1227,1171,56,AWS 2048 MB
aws,node,2048,eu-central-1,1227,1147,80,AWS 2048 MB
aws,node,2048,eu-central-1,1193,1135,58,AWS 2048 MB
aws,node,2048,eu-central-1,1192,1120,72,AWS 2048 MB
aws,node,2048,eu-central-1,1245,1133,112,AWS 2048 MB
aws,node,2048,eu-central-1,1233,1145,88,AWS 2048 MB
aws,node,2048,eu-central-1,1198,1127,71,AWS 2048 MB
aws,node,2048,eu-central-1,1194,1127,67,AWS 2048 MB
aws,node,2048,eu-central-1,1182,1113,69,AWS 2048 MB
aws,node,2048,eu-central-1,1207,1131,76,AWS 2048 MB
aws,node,2048,eu-central-1,1195,1122,73,AWS 2048 MB
aws,node,2048,eu-central-1,1229,1163,66,AWS 2048 MB
aws,node,2048,eu-central-1,1226,1144,82,AWS 2048 MB
aws,node,2048,eu-central-1,1248,1130,118,AWS 2048 MB
aws,node,2048,eu-central-1,1211,1146,65,AWS 2048 MB
aws,node,2048,eu-central-1,1213,1144,69,AWS 2048 MB
aws,node,2048,eu-central-1,1256,1151,105,AWS 2048 MB
azure,node,1536,westeurope,2810,2484,326,Azure 1536 MB
azure,node,1536,westeurope,2674,2460,214,Azure 1536 MB
azure,node,1536,westeurope,2258,2064,194,Azure 1536 MB
azure,node,1536,westeurope,2365,2231,134,Azure 1536 MB
azure,node,1536,westeurope,2310,2126,184,Azure 1536 MB
azure,node,1536,westeurope,2729,2552,177,Azure 1536 MB
azure,node,1536,westeurope,2457,2282,175,Azure 1536 MB
azure,node,1536,westeurope,2434,2167,267,Azure 1536 MB
azure,node,1536,westeurope,2359,2158,201,Azure 1536 MB
azure,node,1536,westeurope,2352,2186,166,Azure 1536 MB
azure,node,1536,westeurope,2380,2182,198,Azure 1536 MB
azure,node,1536,westeurope,2441,2282,159,Azure 1536 MB
azure,node,1536,westeurope,2270,2069,201,Azure 1536 MB
azure,node,1536,westeurope,2507,2311,196,Azure 1536 MB
azure,node,1536,westeurope,2344,2104,240,Azure 1536 MB
azure,node,1536,westeurope,2343,2152,191,Azure 1536 MB
azure,node,1536,westeurope,2246,2059,187,Azure 1536 MB
azure,node,1536,westeurope,2281,2064,217,Azure 1536 MB
azure,node,1536,westeurope,2396,2196,200,Azure 1536 MB
azure,node,1536,westeurope,2263,2047,216,Azure 1536 MB
azure,node,1536,westeurope,2290,2089,201,Azure 1536 MB
azure,node,1536,westeurope,2303,2027,276,Azure 1536 MB
azure,node,1536,westeurope,2206,2045,161,Azure 1536 MB
azure,node,1536,westeurope,2283,2095,188,Azure 1536 MB
azure,node,1536,westeurope,2250,2036,214,Azure 1536 MB
azure,node,1536,westeurope,2407,2236,171,Azure 1536 MB
azure,node,1536,westeurope,2434,2202,232,Azure 1536 MB
azure,node,1536,westeurope,2818,2252,566,Azure 1536 MB
azure,node,1536,westeurope,2378,2136,242,Azure 1536 MB
azure,node,1536,westeurope,2415,2247,168,Azure 1536 MB
azure,node,1536,westeurope,2259,2046,213,Azure 1536 MB
azure,node,1536,westeurope,2287,2101,186,Azure 1536 MB
azure,node,1536,westeurope,2534,2299,235,Azure 1536 MB
azure,node,1536,westeurope,2525,2307,218,Azure 1536 MB
azure,node,1536,westeurope,2455,2245,210,Azure 1536 MB
azure,node,1536,westeurope,2612,2056,556,Azure 1536 MB
azure,node,1536,westeurope,2160,2005,155,Azure 1536 MB
azure,node,1536,westeurope,2225,2006,219,Azure 1536 MB
azure,node,1536,westeurope,2250,2044,206,Azure 1536 MB
azure,node,1536,westeurope,2339,2138,201,Azure 1536 MB
azure,node,1536,westeurope,2200,1993,207,Azure 1536 MB
azure,node,1536,westeurope,2455,2242,213,Azure 1536 MB
azure,node,1536,westeurope,2386,2115,271,Azure 1536 MB
azure,node,1536,westeurope,2283,2123,160,Azure 1536 MB
azure,node,1536,westeurope,2196,2013,183,Azure 1536 MB
azure,node,1536,westeurope,2274,2078,196,Azure 1536 MB
azure,node,1536,westeurope,2364,2130,234,Azure 1536 MB
azure,node,1536,westeurope,2252,2047,205,Azure 1536 MB
azure,node,1536,westeurope,2534,2283,251,Azure 1536 MB
azure,node,1536,westeurope,2448,2151,297,Azure 1536 MB
azure,node,1536,westeurope,2312,2098,214,Azure 1536 MB
azure,node,1536,westeurope,2850,2215,635,Azure 1536 MB
azure,node,1536,westeurope,2327,2098,229,Azure 1536 MB
azure,node,1536,westeurope,2503,2291,212,Azure 1536 MB
azure,node,1536,westeurope,2306,2116,190,Azure 1536 MB
azure,node,1536,westeurope,2485,2254,231,Azure 1536 MB
azure,node,1536,westeurope,2442,2154,288,Azure 1536 MB
azure,node,1536,westeurope,2329,2130,199,Azure 1536 MB
azure,node,1536,westeurope,2230,2083,147,Azure 1536 MB
azure,node,1536,westeurope,2295,2117,178,Azure 1536 MB
azure,node,1536,westeurope,2560,2329,231,Azure 1536 MB
azure,node,1536,westeurope,2230,2044,186,Azure 1536 MB
azure,node,1536,westeurope,2546,2241,305,Azure 1536 MB
azure,node,1536,westeurope,2372,2178,194,Azure 1536 MB
azure,node,1536,westeurope,2428,2223,205,Azure 1536 MB
azure,node,1536,westeurope,2579,2380,199,Azure 1536 MB
azure,node,1536,westeurope,2239,2060,179,Azure 1536 MB
azure,node,1536,westeurope,2479,2267,212,Azure 1536 MB
azure,node,1536,westeurope,2408,2199,209,Azure 1536 MB
azure,node,1536,westeurope,2548,2225,323,Azure 1536 MB
azure,node,1536,westeurope,2196,2011,185,Azure 1536 MB
azure,node,1536,westeurope,2293,2132,161,Azure 1536 MB
azure,node,1536,westeurope,2213,2027,186,Azure 1536 MB
azure,node,1536,westeurope,2399,2183,216,Azure 1536 MB
azure,node,1536,westeurope,2533,2323,210,Azure 1536 MB
azure,node,1536,westeurope,2411,2183,228,Azure 1536 MB
azure,node,1536,westeurope,2537,2175,362,Azure 1536 MB
azure,node,1536,westeurope,2227,2028,199,Azure 1536 MB
azure,node,1536,westeurope,2276,2073,203,Azure 1536 MB
azure,node,1536,westeurope,2286,2083,203,Azure 1536 MB
azure,node,1536,westeurope,2615,2077,538,Azure 1536 MB
azure,node,1536,westeurope,2571,2286,285,Azure 1536 MB
azure,node,1536,westeurope,2310,2112,198,Azure 1536 MB
azure,node,1536,westeurope,2403,2131,272,Azure 1536 MB
azure,node,1536,westeurope,2221,2067,154,Azure 1536 MB
azure,node,1536,westeurope,2535,2040,495,Azure 1536 MB
azure,node,1536,westeurope,2201,2008,193,Azure 1536 MB
azure,node,1536,westeurope,2265,2063,202,Azure 1536 MB
azure,node,1536,westeurope,2391,2215,176,Azure 1536 MB
azure,node,1536,westeurope,2277,2053,224,Azure 1536 MB
azure,node,1536,westeurope,2497,2207,290,Azure 1536 MB
azure,node,1536,westeurope,2367,2172,195,Azure 1536 MB
azure,node,1536,westeurope,2224,2063,161,Azure 1536 MB
azure,node,1536,westeurope,2486,2266,220,Azure 1536 MB
azure,node,1536,westeurope,2229,2059,170,Azure 1536 MB
azure,node,1536,westeurope,2663,2470,193,Azure 1536 MB
azure,node,1536,westeurope,2426,2153,273,Azure 1536 MB
azure,node,1536,westeurope,2288,2069,219,Azure 1536 MB
azure,node,1536,westeurope,2274,2077,197,Azure 1536 MB
azure,node,1536,westeurope,2380,2182,198,Azure 1536 MB
azureWindows,node,1536,westeurope,6196,5742,454,Azure (Win) 1536 MB
azureWindows,node,1536,westeurope,6351,6185,166,Azure (Win) 1536 MB
azureWindows,node,1536,westeurope,8210,5460,2750,Azure (Win) 1536 MB
azureWindows,node,1536,westeurope,5570,5366,204,Azure (Win) 1536 MB
azureWindows,node,1536,westeurope,5387,5238,149,Azure (Win) 1536 MB
azureWindows,node,1536,westeurope,5461,5279,182,Azure (Win) 1536 MB
azureWindows,node,1536,westeurope,5445,5191,254,Azure (Win) 1536 MB
azureWindows,node,1536,westeurope,39269,12717,26552,Azure (Win) 1536 MB
azureWindows,node,1536,westeurope,5444,5236,208,Azure (Win) 1536 MB
azureWindows,node,1536,westeurope,5637,5469,168,Azure (Win) 1536 MB
azureWindows,node,1536,westeurope,11941,11631,310,Azure (Win) 1536 MB
azureWindows,node,1536,westeurope,7057,6952,105,Azure (Win) 1536 MB
azureWindows,node,1536,westeurope,6659,6506,153,Azure (Win) 1536 MB
azureWindows,node,1536,westeurope,6011,5890,121,Azure (Win) 1536 MB
azureWindows,node,1536,westeurope,5701,5566,135,Azure (Win) 1536 MB
azureWindows,node,1536,westeurope,11350,11116,234,Azure (Win) 1536 MB
azureWindows,node,1536,westeurope,5514,5313,201,Azure (Win) 1536 MB
azureWindows,node,1536,westeurope,8022,7887,135,Azure (Win) 1536 MB
azureWindows,node,1536,westeurope,5497,5332,165,Azure (Win) 1536 MB
azureWindows,node,1536,westeurope,8386,8163,223,Azure (Win) 1536 MB
azureWindows,node,1536,westeurope,5502,5327,175,Azure (Win) 1536 MB
azureWindows,node,1536,westeurope,8181,7950,231,Azure (Win) 1536 MB
azureWindows,node,1536,westeurope,5694,5526,168,Azure (Win) 1536 MB
azureWindows,node,1536,westeurope,8084,7917,167,Azure (Win) 1536 MB
azureWindows,node,1536,westeurope,5536,5374,162,Azure (Win) 1536 MB
azureWindows,node,1536,westeurope,7479,7296,183,Azure (Win) 1536 MB
azureWindows,node,1536,westeurope,5549,5343,206,Azure (Win) 1536 MB
azureWindows,node,1536,westeurope,6378,6241,137,Azure (Win) 1536 MB
azureWindows,node,1536,westeurope,5750,5392,358,Azure (Win) 1536 MB
azureWindows,node,1536,westeurope,5973,5890,83,Azure (Win) 1536 MB
azureWindows,node,1536,westeurope,5571,5398,173,Azure (Win) 1536 MB
azureWindows,node,1536,westeurope,5875,5679,196,Azure (Win) 1536 MB
azureWindows,node,1536,westeurope,5519,5299,220,Azure (Win) 1536 MB
azureWindows,node,1536,westeurope,6525,6406,119,Azure (Win) 1536 MB
azureWindows,node,1536,westeurope,5511,5334,177,Azure (Win) 1536 MB
azureWindows,node,1536,westeurope,6024,5425,599,Azure (Win) 1536 MB
azureWindows,node,1536,westeurope,6484,6388,96,Azure (Win) 1536 MB
azureWindows,node,1536,westeurope,5965,5754,211,Azure (Win) 1536 MB
azureWindows,node,1536,westeurope,6449,6302,147,Azure (Win) 1536 MB
azureWindows,node,1536,westeurope,5582,5408,174,Azure (Win) 1536 MB
azureWindows,node,1536,westeurope,6573,6453,120,Azure (Win) 1536 MB
azureWindows,node,1536,westeurope,5474,5301,173,Azure (Win) 1536 MB
azureWindows,node,1536,westeurope,6549,6300,249,Azure (Win) 1536 MB
azureWindows,node,1536,westeurope,5917,5785,132,Azure (Win) 1536 MB
azureWindows,node,1536,westeurope,6811,6582,229,Azure (Win) 1536 MB
azureWindows,node,1536,westeurope,5500,5279,221,Azure (Win) 1536 MB
azureWindows,node,1536,westeurope,6735,6570,165,Azure (Win) 1536 MB
azureWindows,node,1536,westeurope,5447,5304,143,Azure (Win) 1536 MB
azureWindows,node,1536,westeurope,6593,6428,165,Azure (Win) 1536 MB
azureWindows,node,1536,westeurope,5533,5300,233,Azure (Win) 1536 MB
azureWindows,node,1536,westeurope,6439,6298,141,Azure (Win) 1536 MB
azureWindows,node,1536,westeurope,5539,5402,137,Azure (Win) 1536 MB
azureWindows,node,1536,westeurope,6422,6249,173,Azure (Win) 1536 MB
azureWindows,node,1536,westeurope,5384,5238,146,Azure (Win) 1536 MB
azureWindows,node,1536,westeurope,6306,6159,147,Azure (Win) 1536 MB
azureWindows,node,1536,westeurope,5429,5290,139,Azure (Win) 1536 MB
azureWindows,node,1536,westeurope,6798,6575,223,Azure (Win) 1536 MB
azureWindows,node,1536,westeurope,5476,5354,122,Azure (Win) 1536 MB
azureWindows,node,1536,westeurope,6454,6333,121,Azure (Win) 1536 MB
azureWindows,node,1536,westeurope,8647,8517,130,Azure (Win) 1536 MB
azureWindows,node,1536,westeurope,6602,6434,168,Azure (Win) 1536 MB
azureWindows,node,1536,westeurope,5464,5237,227,Azure (Win) 1536 MB
azureWindows,node,1536,westeurope,6649,6387,262,Azure (Win) 1536 MB
azureWindows,node,1536,westeurope,5508,5366,142,Azure (Win) 1536 MB
azureWindows,node,1536,westeurope,6660,6520,140,Azure (Win) 1536 MB
azureWindows,node,1536,westeurope,5416,5282,134,Azure (Win) 1536 MB
azureWindows,node,1536,westeurope,6511,6392,119,Azure (Win) 1536 MB
azureWindows,node,1536,westeurope,6015,5864,151,Azure (Win) 1536 MB
azureWindows,node,1536,westeurope,6518,6419,99,Azure (Win) 1536 MB
azureWindows,node,1536,westeurope,5492,5230,262,Azure (Win) 1536 MB
azureWindows,node,1536,westeurope,6435,6325,110,Azure (Win) 1536 MB
azureWindows,node,1536,westeurope,5412,5269,143,Azure (Win) 1536 MB
azureWindows,node,1536,westeurope,6331,6186,145,Azure (Win) 1536 MB
azureWindows,node,1536,westeurope,5361,5233,128,Azure (Win) 1536 MB
azureWindows,node,1536,westeurope,6445,6314,131,Azure (Win) 1536 MB
azureWindows,node,1536,westeurope,5447,5310,137,Azure (Win) 1536 MB
azureWindows,node,1536,westeurope,6332,6123,209,Azure (Win) 1536 MB
azureWindows,node,1536,westeurope,5498,5283,215,Azure (Win) 1536 MB
azureWindows,node,1536,westeurope,6690,6542,148,Azure (Win) 1536 MB
azureWindows,node,1536,westeurope,5413,5282,131,Azure (Win) 1536 MB
azureWindows,node,1536,westeurope,5783,5279,504,Azure (Win) 1536 MB
azureWindows,node,1536,westeurope,5433,5346,87,Azure (Win) 1536 MB
azureWindows,node,1536,westeurope,11584,11363,221,Azure (Win) 1536 MB
azureWindows,node,1536,westeurope,5676,5322,354,Azure (Win) 1536 MB
azureWindows,node,1536,westeurope,6381,6229,152,Azure (Win) 1536 MB
azureWindows,node,1536,westeurope,5362,5235,127,Azure (Win) 1536 MB
azureWindows,node,1536,westeurope,6634,6443,191,Azure (Win) 1536 MB
azureWindows,node,1536,westeurope,5498,5313,185,Azure (Win) 1536 MB
azureWindows,node,1536,westeurope,7203,7082,121,Azure (Win) 1536 MB
azureWindows,node,1536,westeurope,5310,5190,120,Azure (Win) 1536 MB
azureWindows,node,1536,westeurope,6342,6042,300,Azure (Win) 1536 MB
azureWindows,node,1536,westeurope,5401,5245,156,Azure (Win) 1536 MB
azureWindows,node,1536,westeurope,6643,6514,129,Azure (Win) 1536 MB
azureWindows,node,1536,westeurope,5495,5355,140,Azure (Win) 1536 MB
azureWindows,node,1536,westeurope,6872,6737,135,Azure (Win) 1536 MB
azureWindows,node,1536,westeurope,5350,5208,142,Azure (Win) 1536 MB
azureWindows,node,1536,westeurope,6729,6425,304,Azure (Win) 1536 MB
azureWindows,node,1536,westeurope,5359,5235,124,Azure (Win) 1536 MB
azureWindows,node,1536,westeurope,7344,7225,119,Azure (Win) 1536 MB
azureWindows,node,1536,westeurope,5437,5286,151,Azure (Win) 1536 MB
google,node,128,europe-west1,8533,4519,4014,Google 0128 MB
google,node,128,europe-west1,7933,4414,3519,Google 0128 MB
google,node,128,europe-west1,5021,2822,2199,Google 0128 MB
google,node,128,europe-west1,21870,21596,274,Google 0128 MB
google,node,128,europe-west1,5495,2943,2552,Google 0128 MB
google,node,128,europe-west1,17274,17056,218,Google 0128 MB
google,node,128,europe-west1,6097,3494,2603,Google 0128 MB
google,node,128,europe-west1,19571,19069,502,Google 0128 MB
google,node,128,europe-west1,18765,18514,251,Google 0128 MB
google,node,128,europe-west1,18664,18500,164,Google 0128 MB
google,node,128,europe-west1,17571,17448,123,Google 0128 MB
google,node,128,europe-west1,17889,17742,147,Google 0128 MB
google,node,128,europe-west1,17070,16948,122,Google 0128 MB
google,node,128,europe-west1,18964,18298,666,Google 0128 MB
google,node,128,europe-west1,17356,17227,129,Google 0128 MB
google,node,128,europe-west1,19365,17208,2157,Google 0128 MB
google,node,128,europe-west1,22871,22740,131,Google 0128 MB
google,node,128,europe-west1,19160,19018,142,Google 0128 MB
google,node,128,europe-west1,24565,24384,181,Google 0128 MB
google,node,128,europe-west1,17851,17605,246,Google 0128 MB
google,node,128,europe-west1,24467,24208,259,Google 0128 MB
google,node,128,europe-west1,24562,24388,174,Google 0128 MB
google,node,128,europe-west1,18154,18024,130,Google 0128 MB
google,node,128,europe-west1,23957,23601,356,Google 0128 MB
google,node,128,europe-west1,18548,18392,156,Google 0128 MB
google,node,128,europe-west1,24063,23902,161,Google 0128 MB
google,node,128,europe-west1,26145,25818,327,Google 0128 MB
google,node,128,europe-west1,23570,23347,223,Google 0128 MB
google,node,128,europe-west1,20839,20689,150,Google 0128 MB
google,node,128,europe-west1,20946,20798,148,Google 0128 MB
google,node,128,europe-west1,22379,22101,278,Google 0128 MB
google,node,128,europe-west1,19334,19104,230,Google 0128 MB
google,node,128,europe-west1,23666,23516,150,Google 0128 MB
google,node,128,europe-west1,18331,18194,137,Google 0128 MB
google,node,128,europe-west1,24868,24655,213,Google 0128 MB
google,node,128,europe-west1,6000,3285,2715,Google 0128 MB
google,node,128,europe-west1,5343,3065,2278,Google 0128 MB
google,node,128,europe-west1,17229,17093,136,Google 0128 MB
google,node,128,europe-west1,22842,22395,447,Google 0128 MB
google,node,128,europe-west1,22332,22145,187,Google 0128 MB
google,node,128,europe-west1,16019,15697,322,Google 0128 MB
google,node,128,europe-west1,21834,21667,167,Google 0128 MB
google,node,128,europe-west1,15180,14995,185,Google 0128 MB
google,node,128,europe-west1,15019,14700,319,Google 0128 MB
google,node,128,europe-west1,20824,20593,231,Google 0128 MB
google,node,128,europe-west1,19318,19188,130,Google 0128 MB
google,node,128,europe-west1,14564,14395,169,Google 0128 MB
google,node,128,europe-west1,16213,15997,216,Google 0128 MB
google,node,128,europe-west1,15106,14896,210,Google 0128 MB
google,node,128,europe-west1,18812,18599,213,Google 0128 MB
google,node,128,europe-west1,14863,14734,129,Google 0128 MB
google,node,128,europe-west1,14900,14509,391,Google 0128 MB
google,node,128,europe-west1,16108,15804,304,Google 0128 MB
google,node,128,europe-west1,14818,14685,133,Google 0128 MB
google,node,128,europe-west1,20522,20202,320,Google 0128 MB
google,node,128,europe-west1,15554,15401,153,Google 0128 MB
google,node,128,europe-west1,20811,20671,140,Google 0128 MB
google,node,128,europe-west1,14400,14248,152,Google 0128 MB
google,node,128,europe-west1,15698,15488,210,Google 0128 MB
google,node,128,europe-west1,16252,15206,1046,Google 0128 MB
google,node,128,europe-west1,14779,14645,134,Google 0128 MB
google,node,128,europe-west1,16875,16605,270,Google 0128 MB
google,node,128,europe-west1,15477,15290,187,Google 0128 MB
google,node,128,europe-west1,14564,14393,171,Google 0128 MB
google,node,128,europe-west1,15451,15314,137,Google 0128 MB
google,node,128,europe-west1,17286,17142,144,Google 0128 MB
google,node,128,europe-west1,15164,15045,119,Google 0128 MB
google,node,128,europe-west1,15066,14933,133,Google 0128 MB
google,node,128,europe-west1,15918,15688,230,Google 0128 MB
google,node,128,europe-west1,16678,16554,124,Google 0128 MB
google,node,128,europe-west1,14565,14402,163,Google 0128 MB
google,node,128,europe-west1,15263,15087,176,Google 0128 MB
google,node,128,europe-west1,16217,16097,120,Google 0128 MB
google,node,128,europe-west1,16571,16441,130,Google 0128 MB
google,node,128,europe-west1,15055,14936,119,Google 0128 MB
google,node,128,europe-west1,15963,15701,262,Google 0128 MB
google,node,128,europe-west1,16512,16285,227,Google 0128 MB
google,node,128,europe-west1,14751,14637,114,Google 0128 MB
google,node,128,europe-west1,17563,17422,141,Google 0128 MB
google,node,128,europe-west1,14659,14491,168,Google 0128 MB
google,node,128,europe-west1,15147,14603,544,Google 0128 MB
google,node,128,europe-west1,15893,15579,314,Google 0128 MB
google,node,128,europe-west1,14354,14201,153,Google 0128 MB
google,node,128,europe-west1,16849,16729,120,Google 0128 MB
google,node,128,europe-west1,15039,14806,233,Google 0128 MB
google,node,128,europe-west1,15138,15008,130,Google 0128 MB
google,node,128,europe-west1,16094,15901,193,Google 0128 MB
google,node,128,europe-west1,17446,17318,128,Google 0128 MB
google,node,128,europe-west1,15493,14889,604,Google 0128 MB
google,node,128,europe-west1,16029,15898,131,Google 0128 MB
google,node,128,europe-west1,15290,15097,193,Google 0128 MB
google,node,128,europe-west1,16047,15900,147,Google 0128 MB
google,node,128,europe-west1,17256,17089,167,Google 0128 MB
google,node,128,europe-west1,15051,14932,119,Google 0128 MB
google,node,128,europe-west1,15694,15574,120,Google 0128 MB
google,node,128,europe-west1,15536,15385,151,Google 0128 MB
google,node,128,europe-west1,15439,15306,133,Google 0128 MB
google,node,128,europe-west1,16944,16798,146,Google 0128 MB
google,node,128,europe-west1,14852,14716,136,Google 0128 MB
google,node,128,europe-west1,14829,14701,128,Google 0128 MB
google,node,256,europe-west1,5243,2715,2528,Google 0256 MB
google,node,256,europe-west1,6327,6214,113,Google 0256 MB
google,node,256,europe-west1,7733,6387,1346,Google 0256 MB
google,node,256,europe-west1,9013,6204,2809,Google 0256 MB
google,node,256,europe-west1,10126,6100,4026,Google 0256 MB
google,node,256,europe-west1,12006,6791,5215,Google 0256 MB
google,node,256,europe-west1,10449,3004,7445,Google 0256 MB
google,node,256,europe-west1,10500,8484,2016,Google 0256 MB
google,node,256,europe-west1,8903,8446,457,Google 0256 MB
google,node,256,europe-west1,8026,7504,522,Google 0256 MB
google,node,256,europe-west1,7715,7520,195,Google 0256 MB
google,node,256,europe-west1,8392,8187,205,Google 0256 MB
google,node,256,europe-west1,8679,8204,475,Google 0256 MB
google,node,256,europe-west1,9099,8988,111,Google 0256 MB
google,node,256,europe-west1,9696,9577,119,Google 0256 MB
google,node,256,europe-west1,10374,9978,396,Google 0256 MB
google,node,256,europe-west1,10699,10258,441,Google 0256 MB
google,node,256,europe-west1,8884,8422,462,Google 0256 MB
google,node,256,europe-west1,7939,7807,132,Google 0256 MB
google,node,256,europe-west1,8379,8198,181,Google 0256 MB
google,node,256,europe-west1,8088,7898,190,Google 0256 MB
google,node,256,europe-west1,8550,8188,362,Google 0256 MB
google,node,256,europe-west1,11422,8001,3421,Google 0256 MB
google,node,256,europe-west1,10322,2849,7473,Google 0256 MB
google,node,256,europe-west1,15324,8895,6429,Google 0256 MB
google,node,256,europe-west1,10815,10478,337,Google 0256 MB
google,node,256,europe-west1,17409,12009,5400,Google 0256 MB
google,node,256,europe-west1,17127,11222,5905,Google 0256 MB
google,node,256,europe-west1,7854,7733,121,Google 0256 MB
google,node,256,europe-west1,13517,11025,2492,Google 0256 MB
google,node,256,europe-west1,7467,7336,131,Google 0256 MB
google,node,256,europe-west1,9401,9275,126,Google 0256 MB
google,node,256,europe-west1,9225,9088,137,Google 0256 MB
google,node,256,europe-west1,7663,7548,115,Google 0256 MB
google,node,256,europe-west1,8470,8302,168,Google 0256 MB
google,node,256,europe-west1,8796,8390,406,Google 0256 MB
google,node,256,europe-west1,7626,7438,188,Google 0256 MB
google,node,256,europe-west1,8794,8587,207,Google 0256 MB
google,node,256,europe-west1,7054,6926,128,Google 0256 MB
google,node,256,europe-west1,7834,7713,121,Google 0256 MB
google,node,256,europe-west1,7438,7280,158,Google 0256 MB
google,node,256,europe-west1,9477,9359,118,Google 0256 MB
google,node,256,europe-west1,9383,9264,119,Google 0256 MB
google,node,256,europe-west1,6730,6612,118,Google 0256 MB
google,node,256,europe-west1,9382,9257,125,Google 0256 MB
google,node,256,europe-west1,11760,11590,170,Google 0256 MB
google,node,256,europe-west1,10057,9934,123,Google 0256 MB
google,node,256,europe-west1,6909,6698,211,Google 0256 MB
google,node,256,europe-west1,9650,9532,118,Google 0256 MB
google,node,256,europe-west1,9760,9613,147,Google 0256 MB
google,node,256,europe-west1,7015,6802,213,Google 0256 MB
google,node,256,europe-west1,8933,8786,147,Google 0256 MB
google,node,256,europe-west1,9542,9390,152,Google 0256 MB
google,node,256,europe-west1,6907,6800,107,Google 0256 MB
google,node,256,europe-west1,7085,6965,120,Google 0256 MB
google,node,256,europe-west1,8331,7726,605,Google 0256 MB
google,node,256,europe-west1,6696,6578,118,Google 0256 MB
google,node,256,europe-west1,7764,7416,348,Google 0256 MB
google,node,256,europe-west1,7009,6810,199,Google 0256 MB
google,node,256,europe-west1,7733,7627,106,Google 0256 MB
google,node,256,europe-west1,7590,7481,109,Google 0256 MB
google,node,256,europe-west1,7594,7474,120,Google 0256 MB
google,node,256,europe-west1,8934,8795,139,Google 0256 MB
google,node,256,europe-west1,10924,10776,148,Google 0256 MB
google,node,256,europe-west1,9741,9618,123,Google 0256 MB
google,node,256,europe-west1,7599,7456,143,Google 0256 MB
google,node,256,europe-west1,8177,8062,115,Google 0256 MB
google,node,256,europe-west1,7778,7644,134,Google 0256 MB
google,node,256,europe-west1,7192,7076,116,Google 0256 MB
google,node,256,europe-west1,8721,8594,127,Google 0256 MB
google,node,256,europe-west1,9017,8878,139,Google 0256 MB
google,node,256,europe-west1,7280,6859,421,Google 0256 MB
google,node,256,europe-west1,8525,8389,136,Google 0256 MB
google,node,256,europe-west1,7874,7603,271,Google 0256 MB
google,node,256,europe-west1,7780,7604,176,Google 0256 MB
google,node,256,europe-west1,7618,7402,216,Google 0256 MB
google,node,256,europe-west1,7666,7481,185,Google 0256 MB
google,node,256,europe-west1,9131,8589,542,Google 0256 MB
google,node,256,europe-west1,7863,7758,105,Google 0256 MB
google,node,256,europe-west1,7511,7307,204,Google 0256 MB
google,node,256,europe-west1,7556,7449,107,Google 0256 MB
google,node,256,europe-west1,8623,8407,216,Google 0256 MB
google,node,256,europe-west1,8692,8541,151,Google 0256 MB
google,node,256,europe-west1,7624,7514,110,Google 0256 MB
google,node,256,europe-west1,8609,8486,123,Google 0256 MB
google,node,256,europe-west1,7809,7694,115,Google 0256 MB
google,node,256,europe-west1,9341,9221,120,Google 0256 MB
google,node,256,europe-west1,11128,10890,238,Google 0256 MB
google,node,256,europe-west1,10806,10683,123,Google 0256 MB
google,node,256,europe-west1,12505,11302,1203,Google 0256 MB
google,node,256,europe-west1,10927,10097,830,Google 0256 MB
google,node,256,europe-west1,7576,7411,165,Google 0256 MB
google,node,256,europe-west1,10013,9881,132,Google 0256 MB
google,node,256,europe-west1,9723,9506,217,Google 0256 MB
google,node,256,europe-west1,8160,7988,172,Google 0256 MB
google,node,256,europe-west1,10065,9919,146,Google 0256 MB
google,node,256,europe-west1,11275,11165,110,Google 0256 MB
google,node,256,europe-west1,10966,10847,119,Google 0256 MB
google,node,256,europe-west1,12455,11104,1351,Google 0256 MB
google,node,256,europe-west1,10243,9273,970,Google 0256 MB
google,node,512,europe-west1,3724,3495,229,Google 0512 MB
google,node,512,europe-west1,3550,3420,130,Google 0512 MB
google,node,512,europe-west1,4020,2088,1932,Google 0512 MB
google,node,512,europe-west1,3385,3275,110,Google 0512 MB
google,node,512,europe-west1,3306,3193,113,Google 0512 MB
google,node,512,europe-west1,3677,3501,176,Google 0512 MB
google,node,512,europe-west1,3411,3302,109,Google 0512 MB
google,node,512,europe-west1,3613,3439,174,Google 0512 MB
google,node,512,europe-west1,3612,3450,162,Google 0512 MB
google,node,512,europe-west1,3692,3581,111,Google 0512 MB
google,node,512,europe-west1,3786,3615,171,Google 0512 MB
google,node,512,europe-west1,3280,3116,164,Google 0512 MB
google,node,512,europe-west1,3265,3107,158,Google 0512 MB
google,node,512,europe-west1,3368,3208,160,Google 0512 MB
google,node,512,europe-west1,3459,3293,166,Google 0512 MB
google,node,512,europe-west1,3408,3238,170,Google 0512 MB
google,node,512,europe-west1,3377,3228,149,Google 0512 MB
google,node,512,europe-west1,3486,3324,162,Google 0512 MB
google,node,512,europe-west1,3390,3264,126,Google 0512 MB
google,node,512,europe-west1,3370,3211,159,Google 0512 MB
google,node,512,europe-west1,3795,3572,223,Google 0512 MB
google,node,512,europe-west1,3496,3283,213,Google 0512 MB
google,node,512,europe-west1,3510,3318,192,Google 0512 MB
google,node,512,europe-west1,3503,3305,198,Google 0512 MB
google,node,512,europe-west1,3432,3240,192,Google 0512 MB
google,node,512,europe-west1,3312,3122,190,Google 0512 MB
google,node,512,europe-west1,3490,3302,188,Google 0512 MB
google,node,512,europe-west1,3514,3392,122,Google 0512 MB
google,node,512,europe-west1,3526,3336,190,Google 0512 MB
google,node,512,europe-west1,3904,3427,477,Google 0512 MB
google,node,512,europe-west1,3819,3625,194,Google 0512 MB
google,node,512,europe-west1,3517,3320,197,Google 0512 MB
google,node,512,europe-west1,3468,3314,154,Google 0512 MB
google,node,512,europe-west1,3799,3586,213,Google 0512 MB
google,node,512,europe-west1,3826,3651,175,Google 0512 MB
google,node,512,europe-west1,3572,3381,191,Google 0512 MB
google,node,512,europe-west1,3685,3503,182,Google 0512 MB
google,node,512,europe-west1,3913,3732,181,Google 0512 MB
google,node,512,europe-west1,3880,3697,183,Google 0512 MB
google,node,512,europe-west1,3871,3704,167,Google 0512 MB
google,node,512,europe-west1,3596,3418,178,Google 0512 MB
google,node,512,europe-west1,3571,3397,174,Google 0512 MB
google,node,512,europe-west1,3663,3503,160,Google 0512 MB
google,node,512,europe-west1,3657,3487,170,Google 0512 MB
google,node,512,europe-west1,3876,3710,166,Google 0512 MB
google,node,512,europe-west1,3681,3517,164,Google 0512 MB
google,node,512,europe-west1,4605,4452,153,Google 0512 MB
google,node,512,europe-west1,3599,3479,120,Google 0512 MB
google,node,512,europe-west1,3405,3246,159,Google 0512 MB
google,node,512,europe-west1,3694,3289,405,Google 0512 MB
google,node,512,europe-west1,3489,3321,168,Google 0512 MB
google,node,512,europe-west1,3685,3528,157,Google 0512 MB
google,node,512,europe-west1,3869,3512,357,Google 0512 MB
google,node,512,europe-west1,4207,4039,168,Google 0512 MB
google,node,512,europe-west1,3579,3462,117,Google 0512 MB
google,node,512,europe-west1,3672,3509,163,Google 0512 MB
google,node,512,europe-west1,3866,3557,309,Google 0512 MB
google,node,512,europe-west1,4124,3949,175,Google 0512 MB
google,node,512,europe-west1,3866,3704,162,Google 0512 MB
google,node,512,europe-west1,3487,3365,122,Google 0512 MB
google,node,512,europe-west1,3782,3633,149,Google 0512 MB
google,node,512,europe-west1,3736,3590,146,Google 0512 MB
google,node,512,europe-west1,3672,3536,136,Google 0512 MB
google,node,512,europe-west1,3553,3409,144,Google 0512 MB
google,node,512,europe-west1,3648,3530,118,Google 0512 MB
google,node,512,europe-west1,3648,3510,138,Google 0512 MB
google,node,512,europe-west1,3664,3527,137,Google 0512 MB
google,node,512,europe-west1,3626,3399,227,Google 0512 MB
google,node,512,europe-west1,3545,3425,120,Google 0512 MB
google,node,512,europe-west1,3640,3520,120,Google 0512 MB
google,node,512,europe-west1,3453,3339,114,Google 0512 MB
google,node,512,europe-west1,5047,4886,161,Google 0512 MB
google,node,512,europe-west1,4216,3882,334,Google 0512 MB
google,node,512,europe-west1,4060,3843,217,Google 0512 MB
google,node,512,europe-west1,4429,4289,140,Google 0512 MB
google,node,512,europe-west1,5746,5476,270,Google 0512 MB
google,node,512,europe-west1,5323,4554,769,Google 0512 MB
google,node,512,europe-west1,3566,3415,151,Google 0512 MB
google,node,512,europe-west1,3917,3353,564,Google 0512 MB
google,node,512,europe-west1,3482,3379,103,Google 0512 MB
google,node,512,europe-west1,3760,3288,472,Google 0512 MB
google,node,512,europe-west1,3366,3260,106,Google 0512 MB
google,node,512,europe-west1,3471,3346,125,Google 0512 MB
google,node,512,europe-west1,3676,3520,156,Google 0512 MB
google,node,512,europe-west1,3485,3325,160,Google 0512 MB
google,node,512,europe-west1,3578,3427,151,Google 0512 MB
google,node,512,europe-west1,4042,3882,160,Google 0512 MB
google,node,512,europe-west1,3453,3342,111,Google 0512 MB
google,node,512,europe-west1,3553,3393,160,Google 0512 MB
google,node,512,europe-west1,3733,3420,313,Google 0512 MB
google,node,512,europe-west1,3545,3437,108,Google 0512 MB
google,node,512,europe-west1,3464,3342,122,Google 0512 MB
google,node,512,europe-west1,3562,3324,238,Google 0512 MB
google,node,512,europe-west1,3446,3344,102,Google 0512 MB
google,node,512,europe-west1,3459,3348,111,Google 0512 MB
google,node,512,europe-west1,3354,3219,135,Google 0512 MB
google,node,512,europe-west1,3430,3307,123,Google 0512 MB
google,node,512,europe-west1,3520,3291,229,Google 0512 MB
google,node,512,europe-west1,3347,3241,106,Google 0512 MB
google,node,512,europe-west1,3400,3279,121,Google 0512 MB
google,node,1024,europe-west1,2278,1918,360,Google 1024 MB
google,node,1024,europe-west1,2537,2308,229,Google 1024 MB
google,node,1024,europe-west1,2229,2040,189,Google 1024 MB
google,node,1024,europe-west1,2060,1874,186,Google 1024 MB
google,node,1024,europe-west1,2126,1928,198,Google 1024 MB
google,node,1024,europe-west1,2067,1923,144,Google 1024 MB
google,node,1024,europe-west1,2146,1969,177,Google 1024 MB
google,node,1024,europe-west1,1998,1862,136,Google 1024 MB
google,node,1024,europe-west1,2083,1907,176,Google 1024 MB
google,node,1024,europe-west1,1962,1851,111,Google 1024 MB
google,node,1024,europe-west1,1988,1851,137,Google 1024 MB
google,node,1024,europe-west1,2046,1869,177,Google 1024 MB
google,node,1024,europe-west1,1986,1821,165,Google 1024 MB
google,node,1024,europe-west1,2303,2134,169,Google 1024 MB
google,node,1024,europe-west1,2000,1834,166,Google 1024 MB
google,node,1024,europe-west1,2087,1921,166,Google 1024 MB
google,node,1024,europe-west1,2033,1872,161,Google 1024 MB
google,node,1024,europe-west1,2357,2182,175,Google 1024 MB
google,node,1024,europe-west1,2260,2155,105,Google 1024 MB
google,node,1024,europe-west1,1996,1862,134,Google 1024 MB
google,node,1024,europe-west1,2109,1976,133,Google 1024 MB
google,node,1024,europe-west1,2006,1837,169,Google 1024 MB
google,node,1024,europe-west1,1971,1820,151,Google 1024 MB
google,node,1024,europe-west1,1987,1835,152,Google 1024 MB
google,node,1024,europe-west1,1958,1812,146,Google 1024 MB
google,node,1024,europe-west1,1911,1820,91,Google 1024 MB
google,node,1024,europe-west1,1973,1825,148,Google 1024 MB
google,node,1024,europe-west1,2147,2003,144,Google 1024 MB
google,node,1024,europe-west1,2610,2002,608,Google 1024 MB
google,node,1024,europe-west1,2202,2058,144,Google 1024 MB
google,node,1024,europe-west1,1972,1825,147,Google 1024 MB
google,node,1024,europe-west1,1829,1771,58,Google 1024 MB
google,node,1024,europe-west1,2002,1906,96,Google 1024 MB
google,node,1024,europe-west1,1887,1748,139,Google 1024 MB
google,node,1024,europe-west1,1948,1812,136,Google 1024 MB
google,node,1024,europe-west1,1965,1829,136,Google 1024 MB
google,node,1024,europe-west1,1901,1760,141,Google 1024 MB
google,node,1024,europe-west1,2408,2279,129,Google 1024 MB
google,node,1024,europe-west1,1886,1824,62,Google 1024 MB
google,node,1024,europe-west1,1969,1842,127,Google 1024 MB
google,node,1024,europe-west1,2063,1987,76,Google 1024 MB
google,node,1024,europe-west1,2006,1888,118,Google 1024 MB
google,node,1024,europe-west1,2023,1917,106,Google 1024 MB
google,node,1024,europe-west1,2058,1941,117,Google 1024 MB
google,node,1024,europe-west1,1972,1856,116,Google 1024 MB
google,node,1024,europe-west1,2031,1818,213,Google 1024 MB
google,node,1024,europe-west1,2016,1907,109,Google 1024 MB
google,node,1024,europe-west1,2015,1909,106,Google 1024 MB
google,node,1024,europe-west1,2079,1975,104,Google 1024 MB
google,node,1024,europe-west1,2154,2042,112,Google 1024 MB
google,node,1024,europe-west1,2220,1860,360,Google 1024 MB
google,node,1024,europe-west1,2388,2285,103,Google 1024 MB
google,node,1024,europe-west1,2240,1835,405,Google 1024 MB
google,node,1024,europe-west1,2068,1903,165,Google 1024 MB
google,node,1024,europe-west1,2176,1838,338,Google 1024 MB
google,node,1024,europe-west1,2031,1867,164,Google 1024 MB
google,node,1024,europe-west1,1978,1777,201,Google 1024 MB
google,node,1024,europe-west1,2101,1896,205,Google 1024 MB
google,node,1024,europe-west1,2039,1838,201,Google 1024 MB
google,node,1024,europe-west1,2039,1841,198,Google 1024 MB
google,node,1024,europe-west1,1968,1764,204,Google 1024 MB
google,node,1024,europe-west1,1900,1799,101,Google 1024 MB
google,node,1024,europe-west1,1868,1796,72,Google 1024 MB
google,node,1024,europe-west1,2049,1797,252,Google 1024 MB
google,node,1024,europe-west1,2347,1835,512,Google 1024 MB
google,node,1024,europe-west1,1892,1824,68,Google 1024 MB
google,node,1024,europe-west1,1848,1733,115,Google 1024 MB
google,node,1024,europe-west1,2156,1809,347,Google 1024 MB
google,node,1024,europe-west1,2059,1856,203,Google 1024 MB
google,node,1024,europe-west1,1939,1830,109,Google 1024 MB
google,node,1024,europe-west1,1882,1774,108,Google 1024 MB
google,node,1024,europe-west1,2076,1869,207,Google 1024 MB
google,node,1024,europe-west1,2517,1811,706,Google 1024 MB
google,node,1024,europe-west1,1926,1795,131,Google 1024 MB
google,node,1024,europe-west1,2027,1834,193,Google 1024 MB
google,node,1024,europe-west1,1928,1828,100,Google 1024 MB
google,node,1024,europe-west1,2024,1826,198,Google 1024 MB
google,node,1024,europe-west1,1998,1744,254,Google 1024 MB
google,node,1024,europe-west1,1936,1821,115,Google 1024 MB
google,node,1024,europe-west1,2238,2126,112,Google 1024 MB
google,node,1024,europe-west1,2085,1959,126,Google 1024 MB
google,node,1024,europe-west1,1875,1685,190,Google 1024 MB
google,node,1024,europe-west1,1901,1793,108,Google 1024 MB
google,node,1024,europe-west1,1961,1764,197,Google 1024 MB
google,node,1024,europe-west1,1850,1742,108,Google 1024 MB
google,node,1024,europe-west1,2564,2368,196,Google 1024 MB
google,node,1024,europe-west1,1862,1753,109,Google 1024 MB
google,node,1024,europe-west1,1870,1756,114,Google 1024 MB
google,node,1024,europe-west1,1928,1743,185,Google 1024 MB
google,node,1024,europe-west1,1997,1809,188,Google 1024 MB
google,node,1024,europe-west1,2082,2008,74,Google 1024 MB
google,node,1024,europe-west1,2011,1829,182,Google 1024 MB
google,node,1024,europe-west1,1893,1782,111,Google 1024 MB
google,node,1024,europe-west1,1938,1741,197,Google 1024 MB
google,node,1024,europe-west1,2304,1859,445,Google 1024 MB
google,node,1024,europe-west1,1968,1827,141,Google 1024 MB
google,node,1024,europe-west1,2314,1774,540,Google 1024 MB
google,node,1024,europe-west1,2561,2268,293,Google 1024 MB
google,node,1024,europe-west1,2056,1942,114,Google 1024 MB
google,node,1024,europe-west1,1993,1929,64,Google 1024 MB
google,node,2048,europe-west1,3260,3084,176,Google 2048 MB
google,node,2048,europe-west1,1909,1751,158,Google 2048 MB
google,node,2048,europe-west1,1811,1660,151,Google 2048 MB
google,node,2048,europe-west1,1575,1469,106,Google 2048 MB
google,node,2048,europe-west1,1638,1515,123,Google 2048 MB
google,node,2048,europe-west1,1723,1629,94,Google 2048 MB
google,node,2048,europe-west1,1676,1606,70,Google 2048 MB
google,node,2048,europe-west1,1571,1513,58,Google 2048 MB
google,node,2048,europe-west1,1619,1488,131,Google 2048 MB
google,node,2048,europe-west1,1628,1551,77,Google 2048 MB
google,node,2048,europe-west1,1647,1512,135,Google 2048 MB
google,node,2048,europe-west1,1498,1425,73,Google 2048 MB
google,node,2048,europe-west1,1686,1604,82,Google 2048 MB
google,node,2048,europe-west1,2133,2006,127,Google 2048 MB
google,node,2048,europe-west1,1630,1511,119,Google 2048 MB
google,node,2048,europe-west1,1609,1546,63,Google 2048 MB
google,node,2048,europe-west1,1667,1553,114,Google 2048 MB
google,node,2048,europe-west1,1862,1751,111,Google 2048 MB
google,node,2048,europe-west1,1868,1756,112,Google 2048 MB
google,node,2048,europe-west1,2385,2029,356,Google 2048 MB
google,node,2048,europe-west1,1727,1549,178,Google 2048 MB
google,node,2048,europe-west1,1609,1544,65,Google 2048 MB
google,node,2048,europe-west1,1589,1473,116,Google 2048 MB
google,node,2048,europe-west1,1552,1477,75,Google 2048 MB
google,node,2048,europe-west1,1427,1346,81,Google 2048 MB
google,node,2048,europe-west1,1945,1731,214,Google 2048 MB
google,node,2048,europe-west1,1527,1438,89,Google 2048 MB
google,node,2048,europe-west1,1630,1522,108,Google 2048 MB
google,node,2048,europe-west1,1600,1439,161,Google 2048 MB
google,node,2048,europe-west1,1496,1428,68,Google 2048 MB
google,node,2048,europe-west1,2059,1852,207,Google 2048 MB
google,node,2048,europe-west1,1735,1537,198,Google 2048 MB
google,node,2048,europe-west1,1613,1547,66,Google 2048 MB
google,node,2048,europe-west1,1710,1566,144,Google 2048 MB
google,node,2048,europe-west1,1832,1650,182,Google 2048 MB
google,node,2048,europe-west1,1524,1459,65,Google 2048 MB
google,node,2048,europe-west1,1562,1423,139,Google 2048 MB
google,node,2048,europe-west1,1942,1760,182,Google 2048 MB
google,node,2048,europe-west1,1651,1577,74,Google 2048 MB
google,node,2048,europe-west1,1679,1546,133,Google 2048 MB
google,node,2048,europe-west1,1587,1403,184,Google 2048 MB
google,node,2048,europe-west1,1552,1489,63,Google 2048 MB
google,node,2048,europe-west1,2638,2347,291,Google 2048 MB
google,node,2048,europe-west1,5199,5028,171,Google 2048 MB
google,node,2048,europe-west1,5926,5634,292,Google 2048 MB
google,node,2048,europe-west1,5290,4294,996,Google 2048 MB
google,node,2048,europe-west1,3053,1583,1470,Google 2048 MB
google,node,2048,europe-west1,1673,1541,132,Google 2048 MB
google,node,2048,europe-west1,1818,1677,141,Google 2048 MB
google,node,2048,europe-west1,3300,3140,160,Google 2048 MB
google,node,2048,europe-west1,1983,1847,136,Google 2048 MB
google,node,2048,europe-west1,1572,1496,76,Google 2048 MB
google,node,2048,europe-west1,1682,1542,140,Google 2048 MB
google,node,2048,europe-west1,1699,1535,164,Google 2048 MB
google,node,2048,europe-west1,1680,1608,72,Google 2048 MB
google,node,2048,europe-west1,1656,1585,71,Google 2048 MB
google,node,2048,europe-west1,1773,1560,213,Google 2048 MB
google,node,2048,europe-west1,1764,1653,111,Google 2048 MB
google,node,2048,europe-west1,1834,1630,204,Google 2048 MB
google,node,2048,europe-west1,1815,1608,207,Google 2048 MB
google,node,2048,europe-west1,1586,1521,65,Google 2048 MB
google,node,2048,europe-west1,2365,1765,600,Google 2048 MB
google,node,2048,europe-west1,1697,1552,145,Google 2048 MB
google,node,2048,europe-west1,1803,1669,134,Google 2048 MB
google,node,2048,europe-west1,1634,1443,191,Google 2048 MB
google,node,2048,europe-west1,2250,2059,191,Google 2048 MB
google,node,2048,europe-west1,1692,1628,64,Google 2048 MB
google,node,2048,europe-west1,1728,1596,132,Google 2048 MB
google,node,2048,europe-west1,1762,1640,122,Google 2048 MB
google,node,2048,europe-west1,1821,1654,167,Google 2048 MB
google,node,2048,europe-west1,1795,1630,165,Google 2048 MB
google,node,2048,europe-west1,1977,1626,351,Google 2048 MB
google,node,2048,europe-west1,1617,1497,120,Google 2048 MB
google,node,2048,europe-west1,2726,2549,177,Google 2048 MB
google,node,2048,europe-west1,2785,2608,177,Google 2048 MB
google,node,2048,europe-west1,2085,1933,152,Google 2048 MB
google,node,2048,europe-west1,1823,1620,203,Google 2048 MB
google,node,2048,europe-west1,1785,1673,112,Google 2048 MB
google,node,2048,europe-west1,1576,1513,63,Google 2048 MB
google,node,2048,europe-west1,1654,1583,71,Google 2048 MB
google,node,2048,europe-west1,1653,1563,90,Google 2048 MB
google,node,2048,europe-west1,1601,1526,75,Google 2048 MB
google,node,2048,europe-west1,1673,1592,81,Google 2048 MB
google,node,2048,europe-west1,1635,1502,133,Google 2048 MB
google,node,2048,europe-west1,1776,1659,117,Google 2048 MB
google,node,2048,europe-west1,1848,1660,188,Google 2048 MB
google,node,2048,europe-west1,1751,1636,115,Google 2048 MB
google,node,2048,europe-west1,1995,1873,122,Google 2048 MB
google,node,2048,europe-west1,1833,1705,128,Google 2048 MB
google,node,2048,europe-west1,1691,1560,131,Google 2048 MB
google,node,2048,europe-west1,1598,1485,113,Google 2048 MB
google,node,2048,europe-west1,1676,1556,120,Google 2048 MB
google,node,2048,europe-west1,1657,1532,125,Google 2048 MB
google,node,2048,europe-west1,1781,1660,121,Google 2048 MB
google,node,2048,europe-west1,1613,1494,119,Google 2048 MB
google,node,2048,europe-west1,1804,1411,393,Google 2048 MB
google,node,2048,europe-west1,1603,1498,105,Google 2048 MB
google,node,2048,europe-west1,1583,1508,75,Google 2048 MB
google,node,2048,europe-west1,1616,1505,111,Google 2048 MB
google,node,2048,europe-west1,1592,1421,171,Google 2048 MB
ibm,node,128,eu-de,5069,4763,306,IBM 0128 MB
ibm,node,128,eu-de,4537,4308,229,IBM 0128 MB
ibm,node,128,eu-de,7269,7019,250,IBM 0128 MB
ibm,node,128,eu-de,9001,5629,3372,IBM 0128 MB
ibm,node,128,eu-de,6908,6677,231,IBM 0128 MB
ibm,node,128,eu-de,7307,7098,209,IBM 0128 MB
ibm,node,128,eu-de,5868,5704,164,IBM 0128 MB
ibm,node,128,eu-de,4930,4718,212,IBM 0128 MB
ibm,node,128,eu-de,4510,4284,226,IBM 0128 MB
ibm,node,128,eu-de,4332,4091,241,IBM 0128 MB
ibm,node,128,eu-de,4459,4262,197,IBM 0128 MB
ibm,node,128,eu-de,4915,4627,288,IBM 0128 MB
ibm,node,128,eu-de,5978,5765,213,IBM 0128 MB
ibm,node,128,eu-de,2125,1273,852,IBM 0128 MB
ibm,node,128,eu-de,1268,1110,158,IBM 0128 MB
ibm,node,128,eu-de,1970,1185,785,IBM 0128 MB
ibm,node,128,eu-de,7751,6086,1665,IBM 0128 MB
ibm,node,128,eu-de,2006,1139,867,IBM 0128 MB
ibm,node,128,eu-de,9589,8016,1573,IBM 0128 MB
ibm,node,128,eu-de,3907,3723,184,IBM 0128 MB
ibm,node,128,eu-de,5568,5354,214,IBM 0128 MB
ibm,node,128,eu-de,9323,9135,188,IBM 0128 MB
ibm,node,128,eu-de,1339,1158,181,IBM 0128 MB
ibm,node,128,eu-de,7157,6715,442,IBM 0128 MB
ibm,node,128,eu-de,4156,3923,233,IBM 0128 MB
ibm,node,128,eu-de,1403,1133,270,IBM 0128 MB
ibm,node,128,eu-de,1311,1139,172,IBM 0128 MB
ibm,node,128,eu-de,1303,1126,177,IBM 0128 MB
ibm,node,128,eu-de,1228,1123,105,IBM 0128 MB
ibm,node,128,eu-de,1360,1152,208,IBM 0128 MB
ibm,node,128,eu-de,2777,1738,1039,IBM 0128 MB
ibm,node,128,eu-de,1793,1580,213,IBM 0128 MB
ibm,node,128,eu-de,1440,1161,279,IBM 0128 MB
ibm,node,128,eu-de,1918,1620,298,IBM 0128 MB
ibm,node,128,eu-de,1353,1135,218,IBM 0128 MB
ibm,node,128,eu-de,2252,1813,439,IBM 0128 MB
ibm,node,128,eu-de,1885,1684,201,IBM 0128 MB
ibm,node,128,eu-de,1355,1141,214,IBM 0128 MB
ibm,node,128,eu-de,2226,1988,238,IBM 0128 MB
ibm,node,128,eu-de,1396,1182,214,IBM 0128 MB
ibm,node,128,eu-de,1289,1142,147,IBM 0128 MB
ibm,node,128,eu-de,1368,1134,234,IBM 0128 MB
ibm,node,128,eu-de,1329,1127,202,IBM 0128 MB
ibm,node,128,eu-de,1301,1130,171,IBM 0128 MB
ibm,node,128,eu-de,1310,1157,153,IBM 0128 MB
ibm,node,128,eu-de,1354,1118,236,IBM 0128 MB
ibm,node,128,eu-de,1333,1126,207,IBM 0128 MB
ibm,node,128,eu-de,1352,1150,202,IBM 0128 MB
ibm,node,128,eu-de,1305,1115,190,IBM 0128 MB
ibm,node,128,eu-de,1293,1134,159,IBM 0128 MB
ibm,node,128,eu-de,1318,1115,203,IBM 0128 MB
ibm,node,128,eu-de,1301,1135,166,IBM 0128 MB
ibm,node,128,eu-de,1356,1143,213,IBM 0128 MB
ibm,node,128,eu-de,1350,1149,201,IBM 0128 MB
ibm,node,128,eu-de,1356,1129,227,IBM 0128 MB
ibm,node,128,eu-de,1227,1130,97,IBM 0128 MB
ibm,node,128,eu-de,1288,1116,172,IBM 0128 MB
ibm,node,128,eu-de,2567,1602,965,IBM 0128 MB
ibm,node,128,eu-de,1852,1632,220,IBM 0128 MB
ibm,node,128,eu-de,2212,1629,583,IBM 0128 MB
ibm,node,128,eu-de,2140,1904,236,IBM 0128 MB
ibm,node,128,eu-de,1746,1571,175,IBM 0128 MB
ibm,node,128,eu-de,1784,1598,186,IBM 0128 MB
ibm,node,128,eu-de,1806,1595,211,IBM 0128 MB
ibm,node,128,eu-de,1827,1614,213,IBM 0128 MB
ibm,node,128,eu-de,1937,1718,219,IBM 0128 MB
ibm,node,128,eu-de,1727,1614,113,IBM 0128 MB
ibm,node,128,eu-de,1823,1602,221,IBM 0128 MB
ibm,node,128,eu-de,1734,1574,160,IBM 0128 MB
ibm,node,128,eu-de,1748,1586,162,IBM 0128 MB
ibm,node,128,eu-de,1790,1580,210,IBM 0128 MB
ibm,node,128,eu-de,1800,1633,167,IBM 0128 MB
ibm,node,128,eu-de,1832,1617,215,IBM 0128 MB
ibm,node,128,eu-de,1812,1578,234,IBM 0128 MB
ibm,node,128,eu-de,1768,1588,180,IBM 0128 MB
ibm,node,128,eu-de,1765,1608,157,IBM 0128 MB
ibm,node,128,eu-de,1812,1590,222,IBM 0128 MB
ibm,node,128,eu-de,1753,1587,166,IBM 0128 MB
ibm,node,128,eu-de,1835,1596,239,IBM 0128 MB
ibm,node,128,eu-de,1848,1588,260,IBM 0128 MB
ibm,node,128,eu-de,2108,1586,522,IBM 0128 MB
ibm,node,128,eu-de,1948,1609,339,IBM 0128 MB
ibm,node,128,eu-de,1769,1562,207,IBM 0128 MB
ibm,node,128,eu-de,1801,1578,223,IBM 0128 MB
ibm,node,128,eu-de,1859,1612,247,IBM 0128 MB
ibm,node,128,eu-de,1946,1737,209,IBM 0128 MB
ibm,node,128,eu-de,1826,1622,204,IBM 0128 MB
ibm,node,128,eu-de,1854,1628,226,IBM 0128 MB
ibm,node,128,eu-de,1819,1585,234,IBM 0128 MB
ibm,node,128,eu-de,2941,1767,1174,IBM 0128 MB
ibm,node,128,eu-de,1921,1685,236,IBM 0128 MB
ibm,node,128,eu-de,1943,1711,232,IBM 0128 MB
ibm,node,128,eu-de,1925,1703,222,IBM 0128 MB
ibm,node,128,eu-de,1954,1708,246,IBM 0128 MB
ibm,node,128,eu-de,2017,1805,212,IBM 0128 MB
ibm,node,128,eu-de,1911,1706,205,IBM 0128 MB
ibm,node,128,eu-de,1966,1716,250,IBM 0128 MB
ibm,node,128,eu-de,1975,1696,279,IBM 0128 MB
ibm,node,128,eu-de,1948,1705,243,IBM 0128 MB
ibm,node,128,eu-de,1937,1735,202,IBM 0128 MB
ibm,node,256,eu-de,2076,1772,304,IBM 0256 MB
ibm,node,256,eu-de,1956,1752,204,IBM 0256 MB
ibm,node,256,eu-de,1998,1770,228,IBM 0256 MB
ibm,node,256,eu-de,2080,1848,232,IBM 0256 MB
ibm,node,256,eu-de,1987,1767,220,IBM 0256 MB
ibm,node,256,eu-de,2101,1760,341,IBM 0256 MB
ibm,node,256,eu-de,1950,1752,198,IBM 0256 MB
ibm,node,256,eu-de,1985,1756,229,IBM 0256 MB
ibm,node,256,eu-de,2001,1794,207,IBM 0256 MB
ibm,node,256,eu-de,1967,1755,212,IBM 0256 MB
ibm,node,256,eu-de,2380,1751,629,IBM 0256 MB
ibm,node,256,eu-de,1948,1746,202,IBM 0256 MB
ibm,node,256,eu-de,1908,1772,136,IBM 0256 MB
ibm,node,256,eu-de,2125,1918,207,IBM 0256 MB
ibm,node,256,eu-de,1868,1578,290,IBM 0256 MB
ibm,node,256,eu-de,1789,1546,243,IBM 0256 MB
ibm,node,256,eu-de,2035,1546,489,IBM 0256 MB
ibm,node,256,eu-de,1757,1550,207,IBM 0256 MB
ibm,node,256,eu-de,1698,1530,168,IBM 0256 MB
ibm,node,256,eu-de,1806,1591,215,IBM 0256 MB
ibm,node,256,eu-de,1712,1545,167,IBM 0256 MB
ibm,node,256,eu-de,1747,1532,215,IBM 0256 MB
ibm,node,256,eu-de,1750,1544,206,IBM 0256 MB
ibm,node,256,eu-de,1726,1529,197,IBM 0256 MB
ibm,node,256,eu-de,1732,1536,196,IBM 0256 MB
ibm,node,256,eu-de,1913,1623,290,IBM 0256 MB
ibm,node,256,eu-de,1707,1533,174,IBM 0256 MB
ibm,node,256,eu-de,1760,1528,232,IBM 0256 MB
ibm,node,256,eu-de,1651,1542,109,IBM 0256 MB
ibm,node,256,eu-de,1719,1523,196,IBM 0256 MB
ibm,node,256,eu-de,1715,1539,176,IBM 0256 MB
ibm,node,256,eu-de,1709,1541,168,IBM 0256 MB
ibm,node,256,eu-de,2005,1810,195,IBM 0256 MB
ibm,node,256,eu-de,1711,1547,164,IBM 0256 MB
ibm,node,256,eu-de,1702,1546,156,IBM 0256 MB
ibm,node,256,eu-de,1771,1544,227,IBM 0256 MB
ibm,node,256,eu-de,1745,1546,199,IBM 0256 MB
ibm,node,256,eu-de,1897,1593,304,IBM 0256 MB
ibm,node,256,eu-de,1659,1534,125,IBM 0256 MB
ibm,node,256,eu-de,1755,1542,213,IBM 0256 MB
ibm,node,256,eu-de,1725,1535,190,IBM 0256 MB
ibm,node,256,eu-de,1805,1550,255,IBM 0256 MB
ibm,node,256,eu-de,2079,1841,238,IBM 0256 MB
ibm,node,256,eu-de,1726,1550,176,IBM 0256 MB
ibm,node,256,eu-de,1771,1557,214,IBM 0256 MB
ibm,node,256,eu-de,1989,1777,212,IBM 0256 MB
ibm,node,256,eu-de,1737,1561,176,IBM 0256 MB
ibm,node,256,eu-de,1755,1536,219,IBM 0256 MB
ibm,node,256,eu-de,1688,1527,161,IBM 0256 MB
ibm,node,256,eu-de,1828,1557,271,IBM 0256 MB
ibm,node,256,eu-de,1749,1541,208,IBM 0256 MB
ibm,node,256,eu-de,1902,1553,349,IBM 0256 MB
ibm,node,256,eu-de,2261,1538,723,IBM 0256 MB
ibm,node,256,eu-de,1824,1546,278,IBM 0256 MB
ibm,node,256,eu-de,1633,1532,101,IBM 0256 MB
ibm,node,256,eu-de,1759,1543,216,IBM 0256 MB
ibm,node,256,eu-de,1670,1549,121,IBM 0256 MB
ibm,node,256,eu-de,1759,1543,216,IBM 0256 MB
ibm,node,256,eu-de,1654,1553,101,IBM 0256 MB
ibm,node,256,eu-de,2178,1888,290,IBM 0256 MB
ibm,node,256,eu-de,1738,1571,167,IBM 0256 MB
ibm,node,256,eu-de,1828,1610,218,IBM 0256 MB
ibm,node,256,eu-de,1652,1550,102,IBM 0256 MB
ibm,node,256,eu-de,1761,1538,223,IBM 0256 MB
ibm,node,256,eu-de,2193,1547,646,IBM 0256 MB
ibm,node,256,eu-de,1778,1543,235,IBM 0256 MB
ibm,node,256,eu-de,1693,1527,166,IBM 0256 MB
ibm,node,256,eu-de,1764,1539,225,IBM 0256 MB
ibm,node,256,eu-de,1751,1539,212,IBM 0256 MB
ibm,node,256,eu-de,2311,1944,367,IBM 0256 MB
ibm,node,256,eu-de,1701,1537,164,IBM 0256 MB
ibm,node,256,eu-de,1743,1529,214,IBM 0256 MB
ibm,node,256,eu-de,1699,1534,165,IBM 0256 MB
ibm,node,256,eu-de,1768,1536,232,IBM 0256 MB
ibm,node,256,eu-de,2262,1925,337,IBM 0256 MB
ibm,node,256,eu-de,1759,1541,218,IBM 0256 MB
ibm,node,256,eu-de,2258,1533,725,IBM 0256 MB
ibm,node,256,eu-de,1744,1544,200,IBM 0256 MB
ibm,node,256,eu-de,1698,1536,162,IBM 0256 MB
ibm,node,256,eu-de,1756,1538,218,IBM 0256 MB
ibm,node,256,eu-de,1730,1524,206,IBM 0256 MB
ibm,node,256,eu-de,1774,1545,229,IBM 0256 MB
ibm,node,256,eu-de,1750,1544,206,IBM 0256 MB
ibm,node,256,eu-de,1770,1539,231,IBM 0256 MB
ibm,node,256,eu-de,2117,1834,283,IBM 0256 MB
ibm,node,256,eu-de,1973,1752,221,IBM 0256 MB
ibm,node,256,eu-de,1747,1549,198,IBM 0256 MB
ibm,node,256,eu-de,1749,1550,199,IBM 0256 MB
ibm,node,256,eu-de,1716,1536,180,IBM 0256 MB
ibm,node,256,eu-de,1730,1528,202,IBM 0256 MB
ibm,node,256,eu-de,2120,1848,272,IBM 0256 MB
ibm,node,256,eu-de,1920,1702,218,IBM 0256 MB
ibm,node,256,eu-de,1806,1569,237,IBM 0256 MB
ibm,node,256,eu-de,1682,1526,156,IBM 0256 MB
ibm,node,256,eu-de,2165,1530,635,IBM 0256 MB
ibm,node,256,eu-de,1759,1539,220,IBM 0256 MB
ibm,node,256,eu-de,1741,1541,200,IBM 0256 MB
ibm,node,256,eu-de,1812,1574,238,IBM 0256 MB
ibm,node,256,eu-de,1955,1573,382,IBM 0256 MB
ibm,node,256,eu-de,1796,1593,203,IBM 0256 MB
ibm,node,512,eu-de,1947,1728,219,IBM 0512 MB
ibm,node,512,eu-de,1885,1677,208,IBM 0512 MB
ibm,node,512,eu-de,1916,1686,230,IBM 0512 MB
ibm,node,512,eu-de,1829,1672,157,IBM 0512 MB
ibm,node,512,eu-de,2154,1718,436,IBM 0512 MB
ibm,node,512,eu-de,2063,1721,342,IBM 0512 MB
ibm,node,512,eu-de,1860,1713,147,IBM 0512 MB
ibm,node,512,eu-de,1875,1720,155,IBM 0512 MB
ibm,node,512,eu-de,2379,1732,647,IBM 0512 MB
ibm,node,512,eu-de,1905,1705,200,IBM 0512 MB
ibm,node,512,eu-de,2198,1722,476,IBM 0512 MB
ibm,node,512,eu-de,1864,1672,192,IBM 0512 MB
ibm,node,512,eu-de,1918,1705,213,IBM 0512 MB
ibm,node,512,eu-de,1813,1676,137,IBM 0512 MB
ibm,node,512,eu-de,1843,1693,150,IBM 0512 MB
ibm,node,512,eu-de,1896,1706,190,IBM 0512 MB
ibm,node,512,eu-de,1945,1746,199,IBM 0512 MB
ibm,node,512,eu-de,1889,1694,195,IBM 0512 MB
ibm,node,512,eu-de,1982,1713,269,IBM 0512 MB
ibm,node,512,eu-de,1894,1685,209,IBM 0512 MB
ibm,node,512,eu-de,1946,1741,205,IBM 0512 MB
ibm,node,512,eu-de,1936,1726,210,IBM 0512 MB
ibm,node,512,eu-de,1946,1749,197,IBM 0512 MB
ibm,node,512,eu-de,1954,1729,225,IBM 0512 MB
ibm,node,512,eu-de,1942,1716,226,IBM 0512 MB
ibm,node,512,eu-de,1916,1693,223,IBM 0512 MB
ibm,node,512,eu-de,1908,1696,212,IBM 0512 MB
ibm,node,512,eu-de,1889,1777,112,IBM 0512 MB
ibm,node,512,eu-de,2504,1578,926,IBM 0512 MB
ibm,node,512,eu-de,1756,1530,226,IBM 0512 MB
ibm,node,512,eu-de,1722,1548,174,IBM 0512 MB
ibm,node,512,eu-de,1714,1539,175,IBM 0512 MB
ibm,node,512,eu-de,1712,1525,187,IBM 0512 MB
ibm,node,512,eu-de,1775,1535,240,IBM 0512 MB
ibm,node,512,eu-de,1704,1534,170,IBM 0512 MB
ibm,node,512,eu-de,1673,1530,143,IBM 0512 MB
ibm,node,512,eu-de,1740,1578,162,IBM 0512 MB
ibm,node,512,eu-de,1710,1553,157,IBM 0512 MB
ibm,node,512,eu-de,2853,1757,1096,IBM 0512 MB
ibm,node,512,eu-de,1885,1694,191,IBM 0512 MB
ibm,node,512,eu-de,1909,1710,199,IBM 0512 MB
ibm,node,512,eu-de,1968,1703,265,IBM 0512 MB
ibm,node,512,eu-de,1931,1682,249,IBM 0512 MB
ibm,node,512,eu-de,1879,1692,187,IBM 0512 MB
ibm,node,512,eu-de,1924,1700,224,IBM 0512 MB
ibm,node,512,eu-de,2068,1669,399,IBM 0512 MB
ibm,node,512,eu-de,1886,1679,207,IBM 0512 MB
ibm,node,512,eu-de,1913,1703,210,IBM 0512 MB
ibm,node,512,eu-de,1874,1679,195,IBM 0512 MB
ibm,node,512,eu-de,1839,1686,153,IBM 0512 MB
ibm,node,512,eu-de,1984,1740,244,IBM 0512 MB
ibm,node,512,eu-de,1881,1701,180,IBM 0512 MB
ibm,node,512,eu-de,1900,1703,197,IBM 0512 MB
ibm,node,512,eu-de,1946,1702,244,IBM 0512 MB
ibm,node,512,eu-de,1872,1714,158,IBM 0512 MB
ibm,node,512,eu-de,1884,1663,221,IBM 0512 MB
ibm,node,512,eu-de,1935,1706,229,IBM 0512 MB
ibm,node,512,eu-de,1805,1706,99,IBM 0512 MB
ibm,node,512,eu-de,1924,1728,196,IBM 0512 MB
ibm,node,512,eu-de,1911,1694,217,IBM 0512 MB
ibm,node,512,eu-de,1947,1726,221,IBM 0512 MB
ibm,node,512,eu-de,1913,1714,199,IBM 0512 MB
ibm,node,512,eu-de,1947,1723,224,IBM 0512 MB
ibm,node,512,eu-de,1875,1723,152,IBM 0512 MB
ibm,node,512,eu-de,2377,1755,622,IBM 0512 MB
ibm,node,512,eu-de,1899,1702,197,IBM 0512 MB
ibm,node,512,eu-de,2454,1745,709,IBM 0512 MB
ibm,node,512,eu-de,1926,1735,191,IBM 0512 MB
ibm,node,512,eu-de,1921,1710,211,IBM 0512 MB
ibm,node,512,eu-de,2017,1702,315,IBM 0512 MB
ibm,node,512,eu-de,1913,1723,190,IBM 0512 MB
ibm,node,512,eu-de,1981,1746,235,IBM 0512 MB
ibm,node,512,eu-de,2151,1737,414,IBM 0512 MB
ibm,node,512,eu-de,1943,1737,206,IBM 0512 MB
ibm,node,512,eu-de,1949,1756,193,IBM 0512 MB
ibm,node,512,eu-de,1924,1720,204,IBM 0512 MB
ibm,node,512,eu-de,1915,1712,203,IBM 0512 MB
ibm,node,512,eu-de,1920,1701,219,IBM 0512 MB
ibm,node,512,eu-de,2426,1714,712,IBM 0512 MB
ibm,node,512,eu-de,1904,1718,186,IBM 0512 MB
ibm,node,512,eu-de,1920,1709,211,IBM 0512 MB
ibm,node,512,eu-de,1847,1698,149,IBM 0512 MB
ibm,node,512,eu-de,1915,1696,219,IBM 0512 MB
ibm,node,512,eu-de,1856,1701,155,IBM 0512 MB
ibm,node,512,eu-de,1917,1718,199,IBM 0512 MB
ibm,node,512,eu-de,1814,1669,145,IBM 0512 MB
ibm,node,512,eu-de,1921,1727,194,IBM 0512 MB
ibm,node,512,eu-de,1915,1688,227,IBM 0512 MB
ibm,node,512,eu-de,1894,1700,194,IBM 0512 MB
ibm,node,512,eu-de,1923,1717,206,IBM 0512 MB
ibm,node,512,eu-de,1894,1697,197,IBM 0512 MB
ibm,node,512,eu-de,2260,1683,577,IBM 0512 MB
ibm,node,512,eu-de,1890,1680,210,IBM 0512 MB
ibm,node,512,eu-de,1874,1676,198,IBM 0512 MB
ibm,node,512,eu-de,2259,1744,515,IBM 0512 MB
ibm,node,512,eu-de,2147,1704,443,IBM 0512 MB
ibm,node,512,eu-de,1900,1696,204,IBM 0512 MB
ibm,node,512,eu-de,1889,1688,201,IBM 0512 MB
ibm,node,512,eu-de,1984,1707,277,IBM 0512 MB
ibm,node,512,eu-de,2286,1697,589,IBM 0512 MB
ibm,node,1024,eu-de,2173,1739,434,IBM 1024 MB
ibm,node,1024,eu-de,1869,1714,155,IBM 1024 MB
ibm,node,1024,eu-de,2451,1734,717,IBM 1024 MB
ibm,node,1024,eu-de,1872,1723,149,IBM 1024 MB
ibm,node,1024,eu-de,1931,1744,187,IBM 1024 MB
ibm,node,1024,eu-de,1910,1740,170,IBM 1024 MB
ibm,node,1024,eu-de,1934,1731,203,IBM 1024 MB
ibm,node,1024,eu-de,1887,1727,160,IBM 1024 MB
ibm,node,1024,eu-de,1887,1687,200,IBM 1024 MB
ibm,node,1024,eu-de,1927,1704,223,IBM 1024 MB
ibm,node,1024,eu-de,1854,1683,171,IBM 1024 MB
ibm,node,1024,eu-de,2104,1709,395,IBM 1024 MB
ibm,node,1024,eu-de,1908,1708,200,IBM 1024 MB
ibm,node,1024,eu-de,1905,1711,194,IBM 1024 MB
ibm,node,1024,eu-de,1971,1708,263,IBM 1024 MB
ibm,node,1024,eu-de,1891,1688,203,IBM 1024 MB
ibm,node,1024,eu-de,1929,1716,213,IBM 1024 MB
ibm,node,1024,eu-de,1955,1723,232,IBM 1024 MB
ibm,node,1024,eu-de,1919,1686,233,IBM 1024 MB
ibm,node,1024,eu-de,1922,1713,209,IBM 1024 MB
ibm,node,1024,eu-de,2107,1699,408,IBM 1024 MB
ibm,node,1024,eu-de,1916,1714,202,IBM 1024 MB
ibm,node,1024,eu-de,1905,1695,210,IBM 1024 MB
ibm,node,1024,eu-de,2133,1892,241,IBM 1024 MB
ibm,node,1024,eu-de,2507,1562,945,IBM 1024 MB
ibm,node,1024,eu-de,1694,1526,168,IBM 1024 MB
ibm,node,1024,eu-de,1675,1524,151,IBM 1024 MB
ibm,node,1024,eu-de,1719,1523,196,IBM 1024 MB
ibm,node,1024,eu-de,1766,1538,228,IBM 1024 MB
ibm,node,1024,eu-de,1739,1540,199,IBM 1024 MB
ibm,node,1024,eu-de,1759,1549,210,IBM 1024 MB
ibm,node,1024,eu-de,1700,1541,159,IBM 1024 MB
ibm,node,1024,eu-de,1696,1536,160,IBM 1024 MB
ibm,node,1024,eu-de,1776,1559,217,IBM 1024 MB
ibm,node,1024,eu-de,1875,1551,324,IBM 1024 MB
ibm,node,1024,eu-de,1915,1549,366,IBM 1024 MB
ibm,node,1024,eu-de,1675,1523,152,IBM 1024 MB
ibm,node,1024,eu-de,1759,1543,216,IBM 1024 MB
ibm,node,1024,eu-de,1676,1564,112,IBM 1024 MB
ibm,node,1024,eu-de,2760,1719,1041,IBM 1024 MB
ibm,node,1024,eu-de,1696,1538,158,IBM 1024 MB
ibm,node,1024,eu-de,1754,1552,202,IBM 1024 MB
ibm,node,1024,eu-de,1731,1524,207,IBM 1024 MB
ibm,node,1024,eu-de,1740,1543,197,IBM 1024 MB
ibm,node,1024,eu-de,1697,1552,145,IBM 1024 MB
ibm,node,1024,eu-de,1795,1544,251,IBM 1024 MB
ibm,node,1024,eu-de,1782,1546,236,IBM 1024 MB
ibm,node,1024,eu-de,1935,1608,327,IBM 1024 MB
ibm,node,1024,eu-de,1756,1555,201,IBM 1024 MB
ibm,node,1024,eu-de,1759,1548,211,IBM 1024 MB
ibm,node,1024,eu-de,1954,1561,393,IBM 1024 MB
ibm,node,1024,eu-de,1692,1556,136,IBM 1024 MB
ibm,node,1024,eu-de,1968,1543,425,IBM 1024 MB
ibm,node,1024,eu-de,2829,1719,1110,IBM 1024 MB
ibm,node,1024,eu-de,2175,1559,616,IBM 1024 MB
ibm,node,1024,eu-de,1688,1539,149,IBM 1024 MB
ibm,node,1024,eu-de,1958,1749,209,IBM 1024 MB
ibm,node,1024,eu-de,1766,1548,218,IBM 1024 MB
ibm,node,1024,eu-de,1760,1555,205,IBM 1024 MB
ibm,node,1024,eu-de,1964,1666,298,IBM 1024 MB
ibm,node,1024,eu-de,1749,1543,206,IBM 1024 MB
ibm,node,1024,eu-de,1759,1556,203,IBM 1024 MB
ibm,node,1024,eu-de,1727,1566,161,IBM 1024 MB
ibm,node,1024,eu-de,2048,1571,477,IBM 1024 MB
ibm,node,1024,eu-de,1753,1565,188,IBM 1024 MB
ibm,node,1024,eu-de,1798,1565,233,IBM 1024 MB
ibm,node,1024,eu-de,1709,1557,152,IBM 1024 MB
ibm,node,1024,eu-de,2152,1528,624,IBM 1024 MB
ibm,node,1024,eu-de,1764,1549,215,IBM 1024 MB
ibm,node,1024,eu-de,1764,1558,206,IBM 1024 MB
ibm,node,1024,eu-de,1752,1546,206,IBM 1024 MB
ibm,node,1024,eu-de,1878,1609,269,IBM 1024 MB
ibm,node,1024,eu-de,2273,1527,746,IBM 1024 MB
ibm,node,1024,eu-de,1742,1540,202,IBM 1024 MB
ibm,node,1024,eu-de,1802,1552,250,IBM 1024 MB
ibm,node,1024,eu-de,1730,1534,196,IBM 1024 MB
ibm,node,1024,eu-de,1759,1568,191,IBM 1024 MB
ibm,node,1024,eu-de,1998,1584,414,IBM 1024 MB
ibm,node,1024,eu-de,1780,1558,222,IBM 1024 MB
ibm,node,1024,eu-de,1748,1551,197,IBM 1024 MB
ibm,node,1024,eu-de,1728,1532,196,IBM 1024 MB
ibm,node,1024,eu-de,1727,1523,204,IBM 1024 MB
ibm,node,1024,eu-de,1742,1539,203,IBM 1024 MB
ibm,node,1024,eu-de,2035,1725,310,IBM 1024 MB
ibm,node,1024,eu-de,1693,1547,146,IBM 1024 MB
ibm,node,1024,eu-de,1779,1545,234,IBM 1024 MB
ibm,node,1024,eu-de,1793,1566,227,IBM 1024 MB
ibm,node,1024,eu-de,1739,1524,215,IBM 1024 MB
ibm,node,1024,eu-de,1762,1527,235,IBM 1024 MB
ibm,node,1024,eu-de,1748,1551,197,IBM 1024 MB
ibm,node,1024,eu-de,1710,1541,169,IBM 1024 MB
ibm,node,1024,eu-de,1792,1526,266,IBM 1024 MB
ibm,node,1024,eu-de,1783,1541,242,IBM 1024 MB
ibm,node,1024,eu-de,1818,1535,283,IBM 1024 MB
ibm,node,1024,eu-de,1732,1540,192,IBM 1024 MB
ibm,node,1024,eu-de,1838,1552,286,IBM 1024 MB
ibm,node,1024,eu-de,2312,1549,763,IBM 1024 MB
ibm,node,1024,eu-de,1927,1546,381,IBM 1024 MB
ibm,node,1024,eu-de,1766,1543,223,IBM 1024 MB
ibm,node,1024,eu-de,2877,1731,1146,IBM 1024 MB
ibm,node,2048,eu-de,1932,1711,221,IBM 2048 MB
ibm,node,2048,eu-de,1928,1707,221,IBM 2048 MB
ibm,node,2048,eu-de,1937,1705,232,IBM 2048 MB
ibm,node,2048,eu-de,1854,1699,155,IBM 2048 MB
ibm,node,2048,eu-de,1909,1689,220,IBM 2048 MB
ibm,node,2048,eu-de,1914,1716,198,IBM 2048 MB
ibm,node,2048,eu-de,1877,1665,212,IBM 2048 MB
ibm,node,2048,eu-de,1889,1677,212,IBM 2048 MB
ibm,node,2048,eu-de,1866,1676,190,IBM 2048 MB
ibm,node,2048,eu-de,2038,1687,351,IBM 2048 MB
ibm,node,2048,eu-de,1927,1704,223,IBM 2048 MB
ibm,node,2048,eu-de,1920,1697,223,IBM 2048 MB
ibm,node,2048,eu-de,1917,1711,206,IBM 2048 MB
ibm,node,2048,eu-de,1912,1685,227,IBM 2048 MB
ibm,node,2048,eu-de,1907,1693,214,IBM 2048 MB
ibm,node,2048,eu-de,1946,1706,240,IBM 2048 MB
ibm,node,2048,eu-de,1887,1688,199,IBM 2048 MB
ibm,node,2048,eu-de,1907,1694,213,IBM 2048 MB
ibm,node,2048,eu-de,1879,1681,198,IBM 2048 MB
ibm,node,2048,eu-de,2388,1675,713,IBM 2048 MB
ibm,node,2048,eu-de,1916,1692,224,IBM 2048 MB
ibm,node,2048,eu-de,1894,1707,187,IBM 2048 MB
ibm,node,2048,eu-de,1912,1692,220,IBM 2048 MB
ibm,node,2048,eu-de,1911,1698,213,IBM 2048 MB
ibm,node,2048,eu-de,1887,1674,213,IBM 2048 MB
ibm,node,2048,eu-de,2142,1679,463,IBM 2048 MB
ibm,node,2048,eu-de,1894,1696,198,IBM 2048 MB
ibm,node,2048,eu-de,2122,1701,421,IBM 2048 MB
ibm,node,2048,eu-de,1885,1677,208,IBM 2048 MB
ibm,node,2048,eu-de,1928,1711,217,IBM 2048 MB
ibm,node,2048,eu-de,1876,1676,200,IBM 2048 MB
ibm,node,2048,eu-de,1898,1697,201,IBM 2048 MB
ibm,node,2048,eu-de,1971,1699,272,IBM 2048 MB
ibm,node,2048,eu-de,1917,1698,219,IBM 2048 MB
ibm,node,2048,eu-de,1866,1682,184,IBM 2048 MB
ibm,node,2048,eu-de,1840,1697,143,IBM 2048 MB
ibm,node,2048,eu-de,1977,1746,231,IBM 2048 MB
ibm,node,2048,eu-de,1904,1698,206,IBM 2048 MB
ibm,node,2048,eu-de,1882,1685,197,IBM 2048 MB
ibm,node,2048,eu-de,2139,1689,450,IBM 2048 MB
ibm,node,2048,eu-de,1901,1685,216,IBM 2048 MB
ibm,node,2048,eu-de,1919,1707,212,IBM 2048 MB
ibm,node,2048,eu-de,1936,1714,222,IBM 2048 MB
ibm,node,2048,eu-de,1972,1684,288,IBM 2048 MB
ibm,node,2048,eu-de,1896,1692,204,IBM 2048 MB
ibm,node,2048,eu-de,2135,1734,401,IBM 2048 MB
ibm,node,2048,eu-de,1891,1725,166,IBM 2048 MB
ibm,node,2048,eu-de,1910,1704,206,IBM 2048 MB
ibm,node,2048,eu-de,1944,1731,213,IBM 2048 MB
ibm,node,2048,eu-de,1925,1699,226,IBM 2048 MB
ibm,node,2048,eu-de,1860,1687,173,IBM 2048 MB
ibm,node,2048,eu-de,2138,1712,426,IBM 2048 MB
ibm,node,2048,eu-de,1887,1685,202,IBM 2048 MB
ibm,node,2048,eu-de,1921,1702,219,IBM 2048 MB
ibm,node,2048,eu-de,1912,1708,204,IBM 2048 MB
ibm,node,2048,eu-de,1905,1673,232,IBM 2048 MB
ibm,node,2048,eu-de,1917,1688,229,IBM 2048 MB
ibm,node,2048,eu-de,1910,1697,213,IBM 2048 MB
ibm,node,2048,eu-de,1942,1708,234,IBM 2048 MB
ibm,node,2048,eu-de,1854,1663,191,IBM 2048 MB
ibm,node,2048,eu-de,1914,1717,197,IBM 2048 MB
ibm,node,2048,eu-de,2431,1709,722,IBM 2048 MB
ibm,node,2048,eu-de,1948,1713,235,IBM 2048 MB
ibm,node,2048,eu-de,1936,1719,217,IBM 2048 MB
ibm,node,2048,eu-de,1903,1698,205,IBM 2048 MB
ibm,node,2048,eu-de,1941,1695,246,IBM 2048 MB
ibm,node,2048,eu-de,1889,1667,222,IBM 2048 MB
ibm,node,2048,eu-de,1914,1679,235,IBM 2048 MB
ibm,node,2048,eu-de,1891,1676,215,IBM 2048 MB
ibm,node,2048,eu-de,1963,1703,260,IBM 2048 MB
ibm,node,2048,eu-de,1915,1716,199,IBM 2048 MB
ibm,node,2048,eu-de,1981,1688,293,IBM 2048 MB
ibm,node,2048,eu-de,1867,1722,145,IBM 2048 MB
ibm,node,2048,eu-de,2060,1735,325,IBM 2048 MB
ibm,node,2048,eu-de,1873,1724,149,IBM 2048 MB
ibm,node,2048,eu-de,2103,1693,410,IBM 2048 MB
ibm,node,2048,eu-de,1895,1682,213,IBM 2048 MB
ibm,node,2048,eu-de,1890,1678,212,IBM 2048 MB
ibm,node,2048,eu-de,1911,1712,199,IBM 2048 MB
ibm,node,2048,eu-de,1900,1685,215,IBM 2048 MB
ibm,node,2048,eu-de,1895,1690,205,IBM 2048 MB
ibm,node,2048,eu-de,1877,1666,211,IBM 2048 MB
ibm,node,2048,eu-de,1912,1715,197,IBM 2048 MB
ibm,node,2048,eu-de,1902,1697,205,IBM 2048 MB
ibm,node,2048,eu-de,1939,1728,211,IBM 2048 MB
ibm,node,2048,eu-de,1949,1692,257,IBM 2048 MB
ibm,node,2048,eu-de,1913,1700,213,IBM 2048 MB
ibm,node,2048,eu-de,1936,1700,236,IBM 2048 MB
ibm,node,2048,eu-de,1927,1713,214,IBM 2048 MB
ibm,node,2048,eu-de,2168,1710,458,IBM 2048 MB
ibm,node,2048,eu-de,1867,1671,196,IBM 2048 MB
ibm,node,2048,eu-de,1914,1684,230,IBM 2048 MB
ibm,node,2048,eu-de,1881,1676,205,IBM 2048 MB
ibm,node,2048,eu-de,1930,1694,236,IBM 2048 MB
ibm,node,2048,eu-de,1895,1699,196,IBM 2048 MB
ibm,node,2048,eu-de,2106,1671,435,IBM 2048 MB
ibm,node,2048,eu-de,1858,1662,196,IBM 2048 MB
ibm,node,2048,eu-de,1939,1713,226,IBM 2048 MB
ibm,node,2048,eu-de,2510,1583,927,IBM 2048 MB
ibm,node,2048,eu-de,1781,1572,209,IBM 2048 MB
