6,google,go,128,europe-west1,1328,1198,130,Google 128 MB, 128 MB
6,google,go,128,europe-west1,1238,1096,142,Google 128 MB, 128 MB
6,google,go,128,europe-west1,941,808,133,Google 128 MB, 128 MB
6,google,go,128,europe-west1,1035,901,134,Google 128 MB, 128 MB
6,google,go,128,europe-west1,1037,901,136,Google 128 MB, 128 MB
6,google,go,128,europe-west1,933,847,86,Google 128 MB, 128 MB
6,google,go,128,europe-west1,1028,956,72,Google 128 MB, 128 MB
6,google,go,128,europe-west1,1125,1000,125,Google 128 MB, 128 MB
6,google,go,128,europe-west1,1120,1000,120,Google 128 MB, 128 MB
6,google,go,128,europe-west1,1021,904,117,Google 128 MB, 128 MB
6,google,go,128,europe-west1,1121,908,213,Google 128 MB, 128 MB
6,google,go,128,europe-west1,922,842,80,Google 128 MB, 128 MB
6,google,go,128,europe-west1,1121,993,128,Google 128 MB, 128 MB
6,google,go,128,europe-west1,1015,897,118,Google 128 MB, 128 MB
6,google,go,128,europe-west1,1124,1002,122,Google 128 MB, 128 MB
6,google,go,128,europe-west1,920,810,110,Google 128 MB, 128 MB
6,google,go,128,europe-west1,1365,1207,158,Google 128 MB, 128 MB
6,google,go,128,europe-west1,1114,1003,111,Google 128 MB, 128 MB
6,google,go,128,europe-west1,1107,1001,106,Google 128 MB, 128 MB
6,google,go,128,europe-west1,1109,1005,104,Google 128 MB, 128 MB
6,google,go,128,europe-west1,1104,1032,72,Google 128 MB, 128 MB
6,google,go,128,europe-west1,812,749,63,Google 128 MB, 128 MB
6,google,go,128,europe-west1,1001,896,105,Google 128 MB, 128 MB
6,google,go,128,europe-west1,1007,907,100,Google 128 MB, 128 MB
6,google,go,128,europe-west1,1001,927,74,Google 128 MB, 128 MB
6,google,go,128,europe-west1,1115,1008,107,Google 128 MB, 128 MB
6,google,go,128,europe-west1,1091,996,95,Google 128 MB, 128 MB
6,google,go,128,europe-west1,993,921,72,Google 128 MB, 128 MB
6,google,go,128,europe-west1,992,894,98,Google 128 MB, 128 MB
6,google,go,128,europe-west1,993,840,153,Google 128 MB, 128 MB
6,google,go,128,europe-west1,988,902,86,Google 128 MB, 128 MB
6,google,go,128,europe-west1,1185,997,188,Google 128 MB, 128 MB
6,google,go,128,europe-west1,1339,1209,130,Google 128 MB, 128 MB
6,google,go,128,europe-west1,1083,1002,81,Google 128 MB, 128 MB
6,google,go,128,europe-west1,1178,1096,82,Google 128 MB, 128 MB
6,google,go,128,europe-west1,1424,1000,424,Google 128 MB, 128 MB
6,google,go,128,europe-west1,1075,995,80,Google 128 MB, 128 MB
6,google,go,128,europe-west1,1321,1192,129,Google 128 MB, 128 MB
6,google,go,128,europe-west1,984,808,176,Google 128 MB, 128 MB
6,google,go,128,europe-west1,1083,1006,77,Google 128 MB, 128 MB
6,google,go,128,europe-west1,980,905,75,Google 128 MB, 128 MB
6,google,go,128,europe-west1,1082,908,174,Google 128 MB, 128 MB
6,google,go,128,europe-west1,1075,1004,71,Google 128 MB, 128 MB
6,google,go,128,europe-west1,970,892,78,Google 128 MB, 128 MBB
6,google,go,128,europe-west1,1267,1003,264,Google 128 MB, 128 MB
6,google,go,128,europe-west1,1161,993,168,Google 128 MB, 128 MB
6,google,go,128,europe-west1,1069,990,79,Google 128 MB, 128 MB
6,google,go,128,europe-west1,1161,997,164,Google 128 MB, 128 MB
6,google,go,128,europe-west1,1272,1107,165,Google 128 MB, 128 MB
6,google,go,128,europe-west1,1064,905,159,Google 128 MB, 128 MB
6,google,go,128,europe-west1,1406,1206,200,Google 128 MB, 128 MB
6,google,go,128,europe-west1,1158,993,165,Google 128 MB, 128 MB
6,google,go,128,europe-west1,1056,963,93,Google 128 MB, 128 MBB
6,google,go,128,europe-west1,1162,1004,158,Google 128 MB, 128 MBB
6,google,go,128,europe-west1,1058,898,160,Google 128 MB, 128 MBB
6,google,go,128,europe-west1,962,897,65,Google 128 MB, 128 MB
6,google,go,128,europe-west1,1057,896,161,Google 128 MB, 128 MB
6,google,go,128,europe-west1,1145,985,160,Google 128 MB, 128 MB
6,google,go,128,europe-west1,1149,1079,70,Google 128 MB, 128 MB
6,google,go,128,europe-west1,1153,1008,145,Google 128 MB, 128 MB
6,google,go,128,europe-west1,1250,900,350,Google 128 MB, 128 MB
6,google,go,128,europe-west1,1119,906,213,Google 128 MB, 128 MB
6,google,go,128,europe-west1,1024,946,78,Google 128 MB, 128 MB
6,google,go,128,europe-west1,1128,907,221,Google 128 MB, 128 MB
6,google,go,128,europe-west1,1229,1105,124,Google 128 MB, 128 MB
6,google,go,128,europe-west1,1024,897,127,Google 128 MB, 128 MB
6,google,go,128,europe-west1,1122,1050,72,Google 128 MB, 128 MB
6,google,go,128,europe-west1,1023,906,117,Google 128 MB, 128 MB
6,google,go,128,europe-west1,915,839,76,Google 128 MB, 128 MB
6,google,go,128,europe-west1,924,805,119,Google 128 MB, 128 MB
6,google,go,128,europe-west1,1013,894,119,Google 128 MB, 128 MB
6,google,go,128,europe-west1,1018,901,117,Google 128 MB, 128 MB
6,google,go,128,europe-west1,1022,803,219,Google 128 MB, 128 MB
6,google,go,128,europe-west1,1016,902,114,Google 128 MB, 128 MB
6,google,go,128,europe-west1,1107,1000,107,Google 128 MB, 128 MB
6,google,go,128,europe-west1,1109,990,119,Google 128 MB, 128 MB
6,google,go,128,europe-west1,1018,910,108,Google 128 MB, 128 MB
6,google,go,128,europe-west1,1262,844,418,Google 128 MB, 128 MB
6,google,go,128,europe-west1,1110,994,116,Google 128 MB, 128 MB
6,google,go,128,europe-west1,1101,950,151,Google 128 MB, 128 MB
6,google,go,128,europe-west1,1106,1041,65,Google 128 MB, 128 MB
6,google,go,128,europe-west1,1444,1287,157,Google 128 MB, 128 MB
6,google,go,128,europe-west1,1452,1209,243,Google 128 MB, 128 MB
6,google,go,128,europe-west1,994,927,67,Google 128 MB, 128 MB
6,google,go,128,europe-west1,1092,1002,90,Google 128 MB, 128 MB
6,google,go,128,europe-west1,1092,1004,88,Google 128 MB, 128 MB
6,google,go,128,europe-west1,996,908,88,Google 128 MB, 128 MB
6,google,go,128,europe-west1,1093,1005,88,Google 128 MB, 128 MB
6,google,go,128,europe-west1,1087,1024,63,Google 128 MB, 128 MB
6,google,go,128,europe-west1,984,904,80,Google 128 MB, 128 MB
6,google,go,128,europe-west1,1181,1098,83,Google 128 MB, 128 MB
6,google,go,128,europe-west1,996,902,94,Google 128 MB, 128 MB
6,google,go,128,europe-west1,997,898,99,Google 128 MB, 128 MB
6,google,go,128,europe-west1,796,725,71,Google 128 MB, 128 MB
6,google,go,128,europe-west1,1093,1000,93,Google 128 MB, 128 MB
6,google,go,128,europe-west1,1086,900,186,Google 128 MB, 128 MB
6,google,go,128,europe-west1,1098,1008,90,Google 128 MB, 128 MB
6,google,go,128,europe-west1,1290,1194,96,Google 128 MB, 128 MB
6,google,go,128,europe-west1,1045,951,94,Google 128 MB, 128 MB
6,google,go,128,europe-west1,795,733,62,Google 128 MB, 128 MB
7,google,go,256,europe-west1,515,396,119,Google 256 MB, 256 MB
7,google,go,256,europe-west1,532,409,123,Google 256 MB, 256 MB
7,google,go,256,europe-west1,532,413,119,Google 256 MB, 256 MB
7,google,go,256,europe-west1,527,409,118,Google 256 MB, 256 MB
7,google,go,256,europe-west1,412,354,58,Google 256 MB, 256 MB
7,google,go,256,europe-west1,518,405,113,Google 256 MB, 256 MB
7,google,go,256,europe-west1,516,406,110,Google 256 MB, 256 MB
7,google,go,256,europe-west1,416,318,98,Google 256 MB, 256 MB
7,google,go,256,europe-west1,512,405,107,Google 256 MB, 256 MB
7,google,go,256,europe-west1,516,410,106,Google 256 MB, 256 MB
7,google,go,256,europe-west1,412,345,67,Google 256 MB, 256 MB
7,google,go,256,europe-west1,515,408,107,Google 256 MB, 256 MB
7,google,go,256,europe-west1,512,408,104,Google 256 MB, 256 MB
7,google,go,256,europe-west1,506,402,104,Google 256 MB, 256 MB
7,google,go,256,europe-west1,431,362,69,Google 256 MB, 256 MB
7,google,go,256,europe-west1,519,412,107,Google 256 MB, 256 MB
7,google,go,256,europe-west1,707,319,388,Google 256 MB, 256 MB
7,google,go,256,europe-west1,495,410,85,Google 256 MB, 256 MB
7,google,go,256,europe-west1,493,405,88,Google 256 MB, 256 MB
7,google,go,256,europe-west1,398,321,77,Google 256 MB, 256 MB
7,google,go,256,europe-west1,681,600,81,Google 256 MB, 256 MB
7,google,go,256,europe-west1,576,497,79,Google 256 MB, 256 MB
7,google,go,256,europe-west1,399,327,72,Google 256 MB, 256 MB
7,google,go,256,europe-west1,489,419,70,Google 256 MB, 256 MB
7,google,go,256,europe-west1,477,409,68,Google 256 MB, 256 MB
7,google,go,256,europe-west1,397,338,59,Google 256 MB, 256 MB
7,google,go,256,europe-west1,492,415,77,Google 256 MB, 256 MB
7,google,go,256,europe-west1,494,405,89,Google 256 MB, 256 MB
7,google,go,256,europe-west1,564,410,154,Google 256 MB, 256 MB
7,google,go,256,europe-west1,470,405,65,Google 256 MB, 256 MB
7,google,go,256,europe-west1,565,401,164,Google 256 MB, 256 MB
7,google,go,256,europe-west1,575,405,170,Google 256 MB, 256 MB
7,google,go,256,europe-west1,573,414,159,Google 256 MB, 256 MB
7,google,go,256,europe-west1,574,414,160,Google 256 MB, 256 MB
7,google,go,256,europe-west1,457,400,57,Google 256 MB, 256 MB
7,google,go,256,europe-west1,460,397,63,Google 256 MB, 256 MB
7,google,go,256,europe-west1,474,389,85,Google 256 MB, 256 MB
7,google,go,256,europe-west1,577,417,160,Google 256 MB, 256 MB
7,google,go,256,europe-west1,565,398,167,Google 256 MB, 256 MB
7,google,go,256,europe-west1,554,479,75,Google 256 MB, 256 MB
7,google,go,256,europe-west1,537,401,136,Google 256 MB, 256 MB
7,google,go,256,europe-west1,437,377,60,Google 256 MB, 256 MB
7,google,go,256,europe-west1,536,475,61,Google 256 MB, 256 MB
7,google,go,256,europe-west1,439,378,61,Google 256 MB, 256 MB
7,google,go,256,europe-west1,535,404,131,Google 256 MB, 256 MB
7,google,go,256,europe-west1,632,502,130,Google 256 MB, 256 MB
7,google,go,256,europe-west1,627,509,118,Google 256 MB, 256 MB
7,google,go,256,europe-west1,531,417,114,Google 256 MB, 256 MB
7,google,go,256,europe-west1,415,355,60,Google 256 MB, 256 MB
7,google,go,256,europe-west1,511,409,102,Google 256 MB, 256 MB
7,google,go,256,europe-west1,689,403,286,Google 256 MB, 256 MB
7,google,go,256,europe-west1,506,405,101,Google 256 MB, 256 MB
7,google,go,256,europe-west1,405,345,60,Google 256 MB, 256 MB
7,google,go,256,europe-west1,510,411,99,Google 256 MB, 256 MB
7,google,go,256,europe-west1,404,348,56,Google 256 MB, 256 MB
7,google,go,256,europe-west1,595,498,97,Google 256 MB, 256 MB
7,google,go,256,europe-west1,518,406,112,Google 256 MB, 256 MB
7,google,go,256,europe-west1,514,411,103,Google 256 MB, 256 MB
7,google,go,256,europe-west1,413,352,61,Google 256 MB, 256 MB
7,google,go,256,europe-west1,413,359,54,Google 256 MB, 256 MB
7,google,go,256,europe-west1,510,411,99,Google 256 MB, 256 MB
7,google,go,256,europe-west1,501,440,61,Google 256 MB, 256 MB
7,google,go,256,europe-west1,500,404,96,Google 256 MB, 256 MB
7,google,go,256,europe-west1,490,400,90,Google 256 MB, 256 MB
7,google,go,256,europe-west1,401,327,74,Google 256 MB, 256 MB
7,google,go,256,europe-west1,487,399,88,Google 256 MB, 256 MB
7,google,go,256,europe-west1,492,405,87,Google 256 MB, 256 MB
7,google,go,256,europe-west1,487,405,82,Google 256 MB, 256 MB
7,google,go,256,europe-west1,506,421,85,Google 256 MB, 256 MB
7,google,go,256,europe-west1,404,344,60,Google 256 MB, 256 MB
7,google,go,256,europe-west1,385,321,64,Google 256 MB, 256 MB
7,google,go,256,europe-west1,488,407,81,Google 256 MB, 256 MB
7,google,go,256,europe-west1,486,412,74,Google 256 MB, 256 MB
7,google,go,256,europe-west1,490,318,172,Google 256 MB, 256 MB
7,google,go,256,europe-west1,480,407,73,Google 256 MB, 256 MB
7,google,go,256,europe-west1,569,498,71,Google 256 MB, 256 MB
7,google,go,256,europe-west1,480,414,66,Google 256 MB, 256 MB
7,google,go,256,europe-west1,377,317,60,Google 256 MB, 256 MB
7,google,go,256,europe-west1,502,428,74,Google 256 MB, 256 MB
7,google,go,256,europe-west1,485,413,72,Google 256 MB, 256 MB
7,google,go,256,europe-west1,493,419,74,Google 256 MB, 256 MB
7,google,go,256,europe-west1,475,402,73,Google 256 MB, 256 MB
7,google,go,256,europe-west1,697,414,283,Google 256 MB, 256 MB
7,google,go,256,europe-west1,436,377,59,Google 256 MB, 256 MB
7,google,go,256,europe-west1,621,504,117,Google 256 MB, 256 MB
7,google,go,256,europe-west1,519,456,63,Google 256 MB, 256 MB
7,google,go,256,europe-west1,603,506,97,Google 256 MB, 256 MB
7,google,go,256,europe-west1,488,394,94,Google 256 MB, 256 MB
7,google,go,256,europe-west1,573,494,79,Google 256 MB, 256 MB
7,google,go,256,europe-west1,381,322,59,Google 256 MB, 256 MB
7,google,go,256,europe-west1,482,404,78,Google 256 MB, 256 MB
7,google,go,256,europe-west1,573,502,71,Google 256 MB, 256 MB
7,google,go,256,europe-west1,573,505,68,Google 256 MB, 256 MB
7,google,go,256,europe-west1,365,304,61,Google 256 MB, 256 MB
7,google,go,256,europe-west1,468,410,58,Google 256 MB, 256 MB
7,google,go,256,europe-west1,581,413,168,Google 256 MB, 256 MB
7,google,go,256,europe-west1,474,410,64,Google 256 MB, 256 MB
7,google,go,256,europe-west1,473,408,65,Google 256 MB, 256 MB
7,google,go,256,europe-west1,672,408,264,Google 256 MB, 256 MB
7,google,go,256,europe-west1,571,420,151,Google 256 MB, 256 MB
8,google,go,512,europe-west1,266,178,88,Google 512 MB, 512 MB
8,google,go,512,europe-west1,246,176,70,Google 512 MB, 512 MB
8,google,go,512,europe-west1,244,177,67,Google 512 MB, 512 MB
8,google,go,512,europe-west1,248,181,67,Google 512 MB, 512 MB
8,google,go,512,europe-west1,259,197,62,Google 512 MB, 512 MB
8,google,go,512,europe-west1,350,219,131,Google 512 MB, 512 MB
8,google,go,512,europe-west1,250,173,77,Google 512 MB, 512 MB
8,google,go,512,europe-west1,349,222,127,Google 512 MB, 512 MB
8,google,go,512,europe-west1,343,209,134,Google 512 MB, 512 MB
8,google,go,512,europe-west1,344,216,128,Google 512 MB, 512 MB
8,google,go,512,europe-west1,257,191,66,Google 512 MB, 512 MB
8,google,go,512,europe-west1,233,173,60,Google 512 MB, 512 MB
8,google,go,512,europe-west1,246,174,72,Google 512 MB, 512 MB
8,google,go,512,europe-west1,351,221,130,Google 512 MB, 512 MB
8,google,go,512,europe-west1,377,253,124,Google 512 MB, 512 MB
8,google,go,512,europe-west1,232,164,68,Google 512 MB, 512 MB
8,google,go,512,europe-west1,342,222,120,Google 512 MB, 512 MB
8,google,go,512,europe-west1,224,161,63,Google 512 MB, 512 MB
8,google,go,512,europe-west1,345,222,123,Google 512 MB, 512 MB
8,google,go,512,europe-west1,332,213,119,Google 512 MB, 512 MB
8,google,go,512,europe-west1,260,203,57,Google 512 MB, 512 MB
8,google,go,512,europe-west1,461,370,91,Google 512 MB, 512 MB
8,google,go,512,europe-west1,423,265,158,Google 512 MB, 512 MB
8,google,go,512,europe-west1,292,209,83,Google 512 MB, 512 MB
8,google,go,512,europe-west1,296,227,69,Google 512 MB, 512 MB
8,google,go,512,europe-west1,379,220,159,Google 512 MB, 512 MB
8,google,go,512,europe-west1,274,192,82,Google 512 MB, 512 MB
8,google,go,512,europe-west1,266,194,72,Google 512 MB, 512 MB
8,google,go,512,europe-west1,372,213,159,Google 512 MB, 512 MB
8,google,go,512,europe-west1,390,248,142,Google 512 MB, 512 MB
8,google,go,512,europe-west1,298,225,73,Google 512 MB, 512 MB
8,google,go,512,europe-west1,445,297,148,Google 512 MB, 512 MB
8,google,go,512,europe-west1,399,296,103,Google 512 MB, 512 MB
8,google,go,512,europe-west1,450,360,90,Google 512 MB, 512 MB
8,google,go,512,europe-west1,397,264,133,Google 512 MB, 512 MB
8,google,go,512,europe-west1,385,218,167,Google 512 MB, 512 MB
8,google,go,512,europe-west1,372,219,153,Google 512 MB, 512 MB
8,google,go,512,europe-west1,367,219,148,Google 512 MB, 512 MB
8,google,go,512,europe-west1,260,192,68,Google 512 MB, 512 MB
8,google,go,512,europe-west1,349,288,61,Google 512 MB, 512 MB
8,google,go,512,europe-west1,384,250,134,Google 512 MB, 512 MB
8,google,go,512,europe-west1,260,202,58,Google 512 MB, 512 MB
8,google,go,512,europe-west1,371,242,129,Google 512 MB, 512 MB
8,google,go,512,europe-west1,338,202,136,Google 512 MB, 512 MB
8,google,go,512,europe-west1,433,172,261,Google 512 MB, 512 MB
8,google,go,512,europe-west1,235,168,67,Google 512 MB, 512 MB
8,google,go,512,europe-west1,393,273,120,Google 512 MB, 512 MB
8,google,go,512,europe-west1,725,241,484,Google 512 MB, 512 MB
8,google,go,512,europe-west1,338,210,128,Google 512 MB, 512 MB
8,google,go,512,europe-west1,356,230,126,Google 512 MB, 512 MB
8,google,go,512,europe-west1,241,178,63,Google 512 MB, 512 MB
8,google,go,512,europe-west1,248,187,61,Google 512 MB, 512 MB
8,google,go,512,europe-west1,442,215,227,Google 512 MB, 512 MB
8,google,go,512,europe-west1,276,207,69,Google 512 MB, 512 MB
8,google,go,512,europe-west1,344,212,132,Google 512 MB, 512 MB
8,google,go,512,europe-west1,339,219,120,Google 512 MB, 512 MB
8,google,go,512,europe-west1,537,221,316,Google 512 MB, 512 MB
8,google,go,512,europe-west1,337,211,126,Google 512 MB, 512 MB
8,google,go,512,europe-west1,250,189,61,Google 512 MB, 512 MB
8,google,go,512,europe-west1,244,169,75,Google 512 MB, 512 MB
8,google,go,512,europe-west1,350,234,116,Google 512 MB, 512 MB
8,google,go,512,europe-west1,324,218,106,Google 512 MB, 512 MB
8,google,go,512,europe-west1,232,160,72,Google 512 MB, 512 MB
8,google,go,512,europe-west1,248,176,72,Google 512 MB, 512 MB
8,google,go,512,europe-west1,238,173,65,Google 512 MB, 512 MB
8,google,go,512,europe-west1,298,191,107,Google 512 MB, 512 MB
8,google,go,512,europe-west1,347,248,99,Google 512 MB, 512 MB
8,google,go,512,europe-west1,286,195,91,Google 512 MB, 512 MB
8,google,go,512,europe-west1,227,161,66,Google 512 MB, 512 MB
8,google,go,512,europe-west1,291,205,86,Google 512 MB, 512 MB
8,google,go,512,europe-west1,283,218,65,Google 512 MB, 512 MB
8,google,go,512,europe-west1,252,186,66,Google 512 MB, 512 MB
8,google,go,512,europe-west1,505,224,281,Google 512 MB, 512 MB
8,google,go,512,europe-west1,414,235,179,Google 512 MB, 512 MB
8,google,go,512,europe-west1,225,163,62,Google 512 MB, 512 MB
8,google,go,512,europe-west1,299,219,80,Google 512 MB, 512 MB
8,google,go,512,europe-west1,352,257,95,Google 512 MB, 512 MB
8,google,go,512,europe-west1,295,198,97,Google 512 MB, 512 MB
8,google,go,512,europe-west1,813,234,579,Google 512 MB, 512 MB
8,google,go,512,europe-west1,335,261,74,Google 512 MB, 512 MB
8,google,go,512,europe-west1,599,206,393,Google 512 MB, 512 MB
8,google,go,512,europe-west1,285,215,70,Google 512 MB, 512 MB
8,google,go,512,europe-west1,286,212,74,Google 512 MB, 512 MB
8,google,go,512,europe-west1,298,215,83,Google 512 MB, 512 MB
8,google,go,512,europe-west1,295,218,77,Google 512 MB, 512 MB
8,google,go,512,europe-west1,365,196,169,Google 512 MB, 512 MB
8,google,go,512,europe-west1,405,232,173,Google 512 MB, 512 MB
8,google,go,512,europe-west1,380,217,163,Google 512 MB, 512 MB
8,google,go,512,europe-west1,384,322,62,Google 512 MB, 512 MB
8,google,go,512,europe-west1,412,244,168,Google 512 MB, 512 MB
8,google,go,512,europe-west1,374,219,155,Google 512 MB, 512 MB
8,google,go,512,europe-west1,294,210,84,Google 512 MB, 512 MB
8,google,go,512,europe-west1,677,200,477,Google 512 MB, 512 MB
8,google,go,512,europe-west1,377,234,143,Google 512 MB, 512 MB
8,google,go,512,europe-west1,275,203,72,Google 512 MB, 512 MB
8,google,go,512,europe-west1,391,239,152,Google 512 MB, 512 MB
8,google,go,512,europe-west1,370,223,147,Google 512 MB, 512 MB
8,google,go,512,europe-west1,278,209,69,Google 512 MB, 512 MB
8,google,go,512,europe-west1,361,226,135,Google 512 MB, 512 MB
8,google,go,512,europe-west1,354,219,135,Google 512 MB, 512 MB
9,google,go,1024,europe-west1,157,90,67,Google 1024 MB, 1024 MB
9,google,go,1024,europe-west1,150,77,73,Google 1024 MB, 1024 MB
9,google,go,1024,europe-west1,167,102,65,Google 1024 MB, 1024 MB
9,google,go,1024,europe-west1,153,89,64,Google 1024 MB, 1024 MB
9,google,go,1024,europe-west1,157,96,61,Google 1024 MB, 1024 MB
9,google,go,1024,europe-west1,159,90,69,Google 1024 MB, 1024 MB
9,google,go,1024,europe-west1,198,129,69,Google 1024 MB, 1024 MB
9,google,go,1024,europe-west1,181,115,66,Google 1024 MB, 1024 MB
9,google,go,1024,europe-west1,174,102,72,Google 1024 MB, 1024 MB
9,google,go,1024,europe-west1,175,118,57,Google 1024 MB, 1024 MB
9,google,go,1024,europe-west1,159,95,64,Google 1024 MB, 1024 MB
9,google,go,1024,europe-west1,140,79,61,Google 1024 MB, 1024 MB
9,google,go,1024,europe-west1,195,118,77,Google 1024 MB, 1024 MB
9,google,go,1024,europe-west1,169,103,66,Google 1024 MB, 1024 MB
9,google,go,1024,europe-west1,154,86,68,Google 1024 MB, 1024 MB
9,google,go,1024,europe-west1,207,123,84,Google 1024 MB, 1024 MB
9,google,go,1024,europe-west1,192,119,73,Google 1024 MB, 1024 MB
9,google,go,1024,europe-west1,192,109,83,Google 1024 MB, 1024 MB
9,google,go,1024,europe-west1,222,137,85,Google 1024 MB, 1024 MB
9,google,go,1024,europe-west1,182,94,88,Google 1024 MB, 1024 MB
9,google,go,1024,europe-west1,193,122,71,Google 1024 MB, 1024 MB
9,google,go,1024,europe-west1,181,117,64,Google 1024 MB, 1024 MB
9,google,go,1024,europe-west1,186,113,73,Google 1024 MB, 1024 MB
9,google,go,1024,europe-west1,152,93,59,Google 1024 MB, 1024 MB
9,google,go,1024,europe-west1,177,113,64,Google 1024 MB, 1024 MB
9,google,go,1024,europe-west1,168,109,59,Google 1024 MB, 1024 MB
9,google,go,1024,europe-west1,218,140,78,Google 1024 MB, 1024 MB
9,google,go,1024,europe-west1,197,130,67,Google 1024 MB, 1024 MB
9,google,go,1024,europe-west1,190,102,88,Google 1024 MB, 1024 MB
9,google,go,1024,europe-west1,193,132,61,Google 1024 MB, 1024 MB
9,google,go,1024,europe-west1,177,118,59,Google 1024 MB, 1024 MB
9,google,go,1024,europe-west1,198,128,70,Google 1024 MB, 1024 MB
9,google,go,1024,europe-west1,208,128,80,Google 1024 MB, 1024 MB
9,google,go,1024,europe-west1,168,110,58,Google 1024 MB, 1024 MB
9,google,go,1024,europe-west1,175,113,62,Google 1024 MB, 1024 MB
9,google,go,1024,europe-west1,170,110,60,Google 1024 MB, 1024 MB
9,google,go,1024,europe-west1,167,93,74,Google 1024 MB, 1024 MB
9,google,go,1024,europe-west1,160,99,61,Google 1024 MB, 1024 MB
9,google,go,1024,europe-west1,264,120,144,Google 1024 MB, 1024 MB
9,google,go,1024,europe-west1,260,118,142,Google 1024 MB, 1024 MB
9,google,go,1024,europe-west1,152,86,66,Google 1024 MB, 1024 MB
9,google,go,1024,europe-west1,173,108,65,Google 1024 MB, 1024 MB
9,google,go,1024,europe-west1,246,113,133,Google 1024 MB, 1024 MB
9,google,go,1024,europe-west1,167,98,69,Google 1024 MB, 1024 MB
9,google,go,1024,europe-west1,155,97,58,Google 1024 MB, 1024 MB
9,google,go,1024,europe-west1,261,127,134,Google 1024 MB, 1024 MB
9,google,go,1024,europe-west1,165,106,59,Google 1024 MB, 1024 MB
9,google,go,1024,europe-west1,179,112,67,Google 1024 MB, 1024 MB
9,google,go,1024,europe-west1,184,118,66,Google 1024 MB, 1024 MB
9,google,go,1024,europe-west1,172,112,60,Google 1024 MB, 1024 MB
9,google,go,1024,europe-west1,275,142,133,Google 1024 MB, 1024 MB
9,google,go,1024,europe-west1,171,110,61,Google 1024 MB, 1024 MB
9,google,go,1024,europe-west1,386,100,286,Google 1024 MB, 1024 MB
9,google,go,1024,europe-west1,251,126,125,Google 1024 MB, 1024 MB
9,google,go,1024,europe-west1,241,114,127,Google 1024 MB, 1024 MB
9,google,go,1024,europe-west1,240,118,122,Google 1024 MB, 1024 MB
9,google,go,1024,europe-west1,180,102,78,Google 1024 MB, 1024 MB
9,google,go,1024,europe-west1,235,117,118,Google 1024 MB, 1024 MB
9,google,go,1024,europe-west1,231,113,118,Google 1024 MB, 1024 MB
9,google,go,1024,europe-west1,160,99,61,Google 1024 MB, 1024 MB
9,google,go,1024,europe-west1,243,124,119,Google 1024 MB, 1024 MB
9,google,go,1024,europe-west1,147,86,61,Google 1024 MB, 1024 MB
9,google,go,1024,europe-west1,189,119,70,Google 1024 MB, 1024 MB
9,google,go,1024,europe-west1,166,112,54,Google 1024 MB, 1024 MB
9,google,go,1024,europe-west1,135,77,58,Google 1024 MB, 1024 MB
9,google,go,1024,europe-west1,170,107,63,Google 1024 MB, 1024 MB
9,google,go,1024,europe-west1,147,88,59,Google 1024 MB, 1024 MB
9,google,go,1024,europe-west1,277,194,83,Google 1024 MB, 1024 MB
9,google,go,1024,europe-west1,173,100,73,Google 1024 MB, 1024 MB
9,google,go,1024,europe-west1,152,88,64,Google 1024 MB, 1024 MB
9,google,go,1024,europe-west1,166,101,65,Google 1024 MB, 1024 MB
9,google,go,1024,europe-west1,148,92,56,Google 1024 MB, 1024 MB
9,google,go,1024,europe-west1,346,279,67,Google 1024 MB, 1024 MB
9,google,go,1024,europe-west1,421,273,148,Google 1024 MB, 1024 MB
9,google,go,1024,europe-west1,170,108,62,Google 1024 MB, 1024 MB
9,google,go,1024,europe-west1,209,131,78,Google 1024 MB, 1024 MB
9,google,go,1024,europe-west1,389,277,112,Google 1024 MB, 1024 MB
9,google,go,1024,europe-west1,237,119,118,Google 1024 MB, 1024 MB
9,google,go,1024,europe-west1,165,101,64,Google 1024 MB, 1024 MB
9,google,go,1024,europe-west1,247,136,111,Google 1024 MB, 1024 MB
9,google,go,1024,europe-west1,241,129,112,Google 1024 MB, 1024 MB
9,google,go,1024,europe-west1,165,107,58,Google 1024 MB, 1024 MB
9,google,go,1024,europe-west1,162,98,64,Google 1024 MB, 1024 MB
9,google,go,1024,europe-west1,224,110,114,Google 1024 MB, 1024 MB
9,google,go,1024,europe-west1,166,97,69,Google 1024 MB, 1024 MB
9,google,go,1024,europe-west1,225,118,107,Google 1024 MB, 1024 MB
9,google,go,1024,europe-west1,160,93,67,Google 1024 MB, 1024 MB
9,google,go,1024,europe-west1,317,219,98,Google 1024 MB, 1024 MB
9,google,go,1024,europe-west1,251,144,107,Google 1024 MB, 1024 MB
9,google,go,1024,europe-west1,232,124,108,Google 1024 MB, 1024 MB
9,google,go,1024,europe-west1,152,88,64,Google 1024 MB, 1024 MB
9,google,go,1024,europe-west1,229,125,104,Google 1024 MB, 1024 MB
9,google,go,1024,europe-west1,238,135,103,Google 1024 MB, 1024 MB
9,google,go,1024,europe-west1,155,94,61,Google 1024 MB, 1024 MB
9,google,go,1024,europe-west1,183,119,64,Google 1024 MB, 1024 MB
9,google,go,1024,europe-west1,230,130,100,Google 1024 MB, 1024 MB
9,google,go,1024,europe-west1,166,104,62,Google 1024 MB, 1024 MB
9,google,go,1024,europe-west1,217,125,92,Google 1024 MB, 1024 MB
9,google,go,1024,europe-west1,156,92,64,Google 1024 MB, 1024 MB
9,google,go,1024,europe-west1,154,98,56,Google 1024 MB, 1024 MB
10,google,go,2048,europe-west1,153,80,73,Google 2048 MB, 2048 MB
10,google,go,2048,europe-west1,152,83,69,Google 2048 MB, 2048 MB
10,google,go,2048,europe-west1,141,82,59,Google 2048 MB, 2048 MB
10,google,go,2048,europe-west1,146,87,59,Google 2048 MB, 2048 MB
10,google,go,2048,europe-west1,144,76,68,Google 2048 MB, 2048 MB
10,google,go,2048,europe-west1,336,181,155,Google 2048 MB, 2048 MB
10,google,go,2048,europe-west1,232,80,152,Google 2048 MB, 2048 MB
10,google,go,2048,europe-west1,141,82,59,Google 2048 MB, 2048 MB
10,google,go,2048,europe-west1,221,75,146,Google 2048 MB, 2048 MB
10,google,go,2048,europe-west1,157,89,68,Google 2048 MB, 2048 MB
10,google,go,2048,europe-west1,148,86,62,Google 2048 MB, 2048 MB
10,google,go,2048,europe-west1,153,80,73,Google 2048 MB, 2048 MB
10,google,go,2048,europe-west1,145,75,70,Google 2048 MB, 2048 MB
10,google,go,2048,europe-west1,162,97,65,Google 2048 MB, 2048 MB
10,google,go,2048,europe-west1,223,79,144,Google 2048 MB, 2048 MB
10,google,go,2048,europe-west1,189,113,76,Google 2048 MB, 2048 MB
10,google,go,2048,europe-west1,139,77,62,Google 2048 MB, 2048 MB
10,google,go,2048,europe-west1,150,83,67,Google 2048 MB, 2048 MB
10,google,go,2048,europe-west1,286,131,155,Google 2048 MB, 2048 MB
10,google,go,2048,europe-west1,183,111,72,Google 2048 MB, 2048 MB
10,google,go,2048,europe-west1,222,78,144,Google 2048 MB, 2048 MB
10,google,go,2048,europe-west1,222,84,138,Google 2048 MB, 2048 MB
10,google,go,2048,europe-west1,215,79,136,Google 2048 MB, 2048 MB
10,google,go,2048,europe-west1,213,79,134,Google 2048 MB, 2048 MB
10,google,go,2048,europe-west1,211,152,59,Google 2048 MB, 2048 MB
10,google,go,2048,europe-west1,148,79,69,Google 2048 MB, 2048 MB
10,google,go,2048,europe-west1,210,80,130,Google 2048 MB, 2048 MB
10,google,go,2048,europe-west1,366,237,129,Google 2048 MB, 2048 MB
10,google,go,2048,europe-west1,171,108,63,Google 2048 MB, 2048 MB
10,google,go,2048,europe-west1,211,89,122,Google 2048 MB, 2048 MB
10,google,go,2048,europe-west1,208,81,127,Google 2048 MB, 2048 MB
10,google,go,2048,europe-west1,145,78,67,Google 2048 MB, 2048 MB
10,google,go,2048,europe-west1,214,103,111,Google 2048 MB, 2048 MB
10,google,go,2048,europe-west1,164,81,83,Google 2048 MB, 2048 MB
10,google,go,2048,europe-west1,138,79,59,Google 2048 MB, 2048 MB
10,google,go,2048,europe-west1,186,129,57,Google 2048 MB, 2048 MB
10,google,go,2048,europe-west1,194,83,111,Google 2048 MB, 2048 MB
10,google,go,2048,europe-west1,188,127,61,Google 2048 MB, 2048 MB
10,google,go,2048,europe-west1,181,85,96,Google 2048 MB, 2048 MB
10,google,go,2048,europe-west1,177,115,62,Google 2048 MB, 2048 MB
10,google,go,2048,europe-west1,370,254,116,Google 2048 MB, 2048 MB
10,google,go,2048,europe-west1,193,97,96,Google 2048 MB, 2048 MB
10,google,go,2048,europe-west1,171,110,61,Google 2048 MB, 2048 MB
10,google,go,2048,europe-west1,163,76,87,Google 2048 MB, 2048 MB
10,google,go,2048,europe-west1,163,80,83,Google 2048 MB, 2048 MB
10,google,go,2048,europe-west1,191,101,90,Google 2048 MB, 2048 MB
10,google,go,2048,europe-west1,172,108,64,Google 2048 MB, 2048 MB
10,google,go,2048,europe-west1,201,134,67,Google 2048 MB, 2048 MB
10,google,go,2048,europe-west1,226,165,61,Google 2048 MB, 2048 MB
10,google,go,2048,europe-west1,582,405,177,Google 2048 MB, 2048 MB
10,google,go,2048,europe-west1,1188,79,1109,Google 2048 MB, 2048 MB
10,google,go,2048,europe-west1,181,121,60,Google 2048 MB, 2048 MB
10,google,go,2048,europe-west1,200,112,88,Google 2048 MB, 2048 MB
10,google,go,2048,europe-west1,142,77,65,Google 2048 MB, 2048 MB
10,google,go,2048,europe-west1,209,112,97,Google 2048 MB, 2048 MB
10,google,go,2048,europe-west1,182,119,63,Google 2048 MB, 2048 MB
10,google,go,2048,europe-west1,294,176,118,Google 2048 MB, 2048 MB
10,google,go,2048,europe-west1,186,125,61,Google 2048 MB, 2048 MB
10,google,go,2048,europe-west1,305,142,163,Google 2048 MB, 2048 MB
10,google,go,2048,europe-west1,156,90,66,Google 2048 MB, 2048 MB
10,google,go,2048,europe-west1,162,100,62,Google 2048 MB, 2048 MB
10,google,go,2048,europe-west1,664,109,555,Google 2048 MB, 2048 MB
10,google,go,2048,europe-west1,217,129,88,Google 2048 MB, 2048 MB
10,google,go,2048,europe-west1,300,221,79,Google 2048 MB, 2048 MB
10,google,go,2048,europe-west1,171,101,70,Google 2048 MB, 2048 MB
10,google,go,2048,europe-west1,159,100,59,Google 2048 MB, 2048 MB
10,google,go,2048,europe-west1,206,148,58,Google 2048 MB, 2048 MB
10,google,go,2048,europe-west1,216,88,128,Google 2048 MB, 2048 MB
10,google,go,2048,europe-west1,152,80,72,Google 2048 MB, 2048 MB
10,google,go,2048,europe-west1,214,141,73,Google 2048 MB, 2048 MB
10,google,go,2048,europe-west1,259,134,125,Google 2048 MB, 2048 MB
10,google,go,2048,europe-west1,227,93,134,Google 2048 MB, 2048 MB
10,google,go,2048,europe-west1,128,75,53,Google 2048 MB, 2048 MB
10,google,go,2048,europe-west1,286,218,68,Google 2048 MB, 2048 MB
10,google,go,2048,europe-west1,217,96,121,Google 2048 MB, 2048 MB
10,google,go,2048,europe-west1,146,92,54,Google 2048 MB, 2048 MB
10,google,go,2048,europe-west1,190,99,91,Google 2048 MB, 2048 MB
10,google,go,2048,europe-west1,164,96,68,Google 2048 MB, 2048 MB
10,google,go,2048,europe-west1,309,227,82,Google 2048 MB, 2048 MB
10,google,go,2048,europe-west1,156,91,65,Google 2048 MB, 2048 MB
10,google,go,2048,europe-west1,203,116,87,Google 2048 MB, 2048 MB
10,google,go,2048,europe-west1,310,167,143,Google 2048 MB, 2048 MB
10,google,go,2048,europe-west1,167,100,67,Google 2048 MB, 2048 MB
10,google,go,2048,europe-west1,172,107,65,Google 2048 MB, 2048 MB
10,google,go,2048,europe-west1,464,362,102,Google 2048 MB, 2048 MB
10,google,go,2048,europe-west1,223,147,76,Google 2048 MB, 2048 MB
10,google,go,2048,europe-west1,336,244,92,Google 2048 MB, 2048 MB
10,google,go,2048,europe-west1,293,150,143,Google 2048 MB, 2048 MB
10,google,go,2048,europe-west1,183,103,80,Google 2048 MB, 2048 MB
10,google,go,2048,europe-west1,187,118,69,Google 2048 MB, 2048 MB
10,google,go,2048,europe-west1,159,95,64,Google 2048 MB, 2048 MB
10,google,go,2048,europe-west1,269,124,145,Google 2048 MB, 2048 MB
10,google,go,2048,europe-west1,176,110,66,Google 2048 MB, 2048 MB
10,google,go,2048,europe-west1,197,129,68,Google 2048 MB, 2048 MB
10,google,go,2048,europe-west1,190,117,73,Google 2048 MB, 2048 MB
10,google,go,2048,europe-west1,413,102,311,Google 2048 MB, 2048 MB
10,google,go,2048,europe-west1,192,119,73,Google 2048 MB, 2048 MB
10,google,go,2048,europe-west1,185,120,65,Google 2048 MB, 2048 MB
10,google,go,2048,europe-west1,302,226,76,Google 2048 MB, 2048 MB
10,google,go,2048,europe-west1,208,137,71,Google 2048 MB, 2048 MB
