cloud,runtime,memory_mb,region,total_ms,measured_ms,latency_ms,name
aws,go,128,eu-central-1,1123,964,159,AWS 0128 MB
aws,go,128,eu-central-1,1061,961,100,AWS 0128 MB
aws,go,128,eu-central-1,960,864,96,AWS 0128 MB
aws,go,128,eu-central-1,1022,940,82,AWS 0128 MB
aws,go,128,eu-central-1,1020,940,80,AWS 0128 MB
aws,go,128,eu-central-1,1001,908,93,AWS 0128 MB
aws,go,128,eu-central-1,1013,936,77,AWS 0128 MB
aws,go,128,eu-central-1,1010,928,82,AWS 0128 MB
aws,go,128,eu-central-1,1065,920,145,AWS 0128 MB
aws,go,128,eu-central-1,984,888,96,AWS 0128 MB
aws,go,128,eu-central-1,992,908,84,AWS 0128 MB
aws,go,128,eu-central-1,1079,995,84,AWS 0128 MB
aws,go,128,eu-central-1,989,921,68,AWS 0128 MB
aws,go,128,eu-central-1,1040,940,100,AWS 0128 MB
aws,go,128,eu-central-1,1022,940,82,AWS 0128 MB
aws,go,128,eu-central-1,1038,960,78,AWS 0128 MB
aws,go,128,eu-central-1,1015,940,75,AWS 0128 MB
aws,go,128,eu-central-1,1053,961,92,AWS 0128 MB
aws,go,128,eu-central-1,1008,908,100,AWS 0128 MB
aws,go,128,eu-central-1,1024,952,72,AWS 0128 MB
aws,go,128,eu-central-1,1026,952,74,AWS 0128 MB
aws,go,128,eu-central-1,993,924,69,AWS 0128 MB
aws,go,128,eu-central-1,1009,948,61,AWS 0128 MB
aws,go,128,eu-central-1,1002,912,90,AWS 0128 MB
aws,go,128,eu-central-1,1038,922,116,AWS 0128 MB
aws,go,128,eu-central-1,1023,909,114,AWS 0128 MB
aws,go,128,eu-central-1,1034,932,102,AWS 0128 MB
aws,go,128,eu-central-1,1038,948,90,AWS 0128 MB
aws,go,128,eu-central-1,1084,945,139,AWS 0128 MB
aws,go,128,eu-central-1,1081,997,84,AWS 0128 MB
aws,go,128,eu-central-1,970,887,83,AWS 0128 MB
aws,go,128,eu-central-1,1072,988,84,AWS 0128 MB
aws,go,128,eu-central-1,941,872,69,AWS 0128 MB
aws,go,128,eu-central-1,992,912,80,AWS 0128 MB
aws,go,128,eu-central-1,945,874,71,AWS 0128 MB
aws,go,128,eu-central-1,1265,952,313,AWS 0128 MB
aws,go,128,eu-central-1,945,860,85,AWS 0128 MB
aws,go,128,eu-central-1,1062,972,90,AWS 0128 MB
aws,go,128,eu-central-1,1023,936,87,AWS 0128 MB
aws,go,128,eu-central-1,1053,977,76,AWS 0128 MB
aws,go,128,eu-central-1,985,924,61,AWS 0128 MB
aws,go,128,eu-central-1,1041,944,97,AWS 0128 MB
aws,go,128,eu-central-1,996,924,72,AWS 0128 MB
aws,go,128,eu-central-1,1016,935,81,AWS 0128 MB
aws,go,128,eu-central-1,995,916,79,AWS 0128 MB
aws,go,128,eu-central-1,1013,900,113,AWS 0128 MB
aws,go,128,eu-central-1,1048,977,71,AWS 0128 MB
aws,go,128,eu-central-1,1066,980,86,AWS 0128 MB
aws,go,128,eu-central-1,985,880,105,AWS 0128 MB
aws,go,128,eu-central-1,1006,940,66,AWS 0128 MB
aws,go,128,eu-central-1,1042,940,102,AWS 0128 MB
aws,go,128,eu-central-1,1025,941,84,AWS 0128 MB
aws,go,128,eu-central-1,1006,924,82,AWS 0128 MB
aws,go,128,eu-central-1,1043,968,75,AWS 0128 MB
aws,go,128,eu-central-1,1063,975,88,AWS 0128 MB
aws,go,128,eu-central-1,1023,954,69,AWS 0128 MB
aws,go,128,eu-central-1,1035,961,74,AWS 0128 MB
aws,go,128,eu-central-1,1052,964,88,AWS 0128 MB
aws,go,128,eu-central-1,1032,957,75,AWS 0128 MB
aws,go,128,eu-central-1,1111,999,112,AWS 0128 MB
aws,go,128,eu-central-1,1246,943,303,AWS 0128 MB
aws,go,128,eu-central-1,1006,898,108,AWS 0128 MB
aws,go,128,eu-central-1,1008,936,72,AWS 0128 MB
aws,go,128,eu-central-1,1010,940,70,AWS 0128 MB
aws,go,128,eu-central-1,990,915,75,AWS 0128 MB
aws,go,128,eu-central-1,1026,940,86,AWS 0128 MB
aws,go,128,eu-central-1,1044,971,73,AWS 0128 MB
aws,go,128,eu-central-1,946,871,75,AWS 0128 MB
aws,go,128,eu-central-1,1081,996,85,AWS 0128 MB
aws,go,128,eu-central-1,980,881,99,AWS 0128 MB
aws,go,128,eu-central-1,1063,980,83,AWS 0128 MB
aws,go,128,eu-central-1,1042,964,78,AWS 0128 MB
aws,go,128,eu-central-1,1081,1004,77,AWS 0128 MB
aws,go,128,eu-central-1,1003,915,88,AWS 0128 MB
aws,go,128,eu-central-1,1057,941,116,AWS 0128 MB
aws,go,128,eu-central-1,1069,969,100,AWS 0128 MB
aws,go,128,eu-central-1,1038,960,78,AWS 0128 MB
aws,go,128,eu-central-1,1257,888,369,AWS 0128 MB
aws,go,128,eu-central-1,990,900,90,AWS 0128 MB
aws,go,128,eu-central-1,934,848,86,AWS 0128 MB
aws,go,128,eu-central-1,1405,972,433,AWS 0128 MB
aws,go,128,eu-central-1,1143,976,167,AWS 0128 MB
aws,go,128,eu-central-1,1009,932,77,AWS 0128 MB
aws,go,128,eu-central-1,1058,979,79,AWS 0128 MB
aws,go,128,eu-central-1,974,881,93,AWS 0128 MB
aws,go,128,eu-central-1,1001,908,93,AWS 0128 MB
aws,go,128,eu-central-1,1055,957,98,AWS 0128 MB
aws,go,128,eu-central-1,1016,940,76,AWS 0128 MB
aws,go,128,eu-central-1,992,912,80,AWS 0128 MB
aws,go,128,eu-central-1,1013,931,82,AWS 0128 MB
aws,go,128,eu-central-1,974,904,70,AWS 0128 MB
aws,go,128,eu-central-1,1017,924,93,AWS 0128 MB
aws,go,128,eu-central-1,1002,932,70,AWS 0128 MB
aws,go,128,eu-central-1,1020,944,76,AWS 0128 MB
aws,go,128,eu-central-1,1020,945,75,AWS 0128 MB
aws,go,128,eu-central-1,997,928,69,AWS 0128 MB
aws,go,128,eu-central-1,1035,904,131,AWS 0128 MB
aws,go,128,eu-central-1,979,891,88,AWS 0128 MB
aws,go,128,eu-central-1,973,876,97,AWS 0128 MB
aws,go,128,eu-central-1,992,915,77,AWS 0128 MB
aws,go,256,eu-central-1,568,460,108,AWS 0256 MB
aws,go,256,eu-central-1,517,443,74,AWS 0256 MB
aws,go,256,eu-central-1,498,425,73,AWS 0256 MB
aws,go,256,eu-central-1,550,473,77,AWS 0256 MB
aws,go,256,eu-central-1,545,466,79,AWS 0256 MB
aws,go,256,eu-central-1,561,485,76,AWS 0256 MB
aws,go,256,eu-central-1,524,452,72,AWS 0256 MB
aws,go,256,eu-central-1,521,430,91,AWS 0256 MB
aws,go,256,eu-central-1,539,472,67,AWS 0256 MB
aws,go,256,eu-central-1,538,461,77,AWS 0256 MB
aws,go,256,eu-central-1,518,461,57,AWS 0256 MB
aws,go,256,eu-central-1,537,460,77,AWS 0256 MB
aws,go,256,eu-central-1,515,448,67,AWS 0256 MB
aws,go,256,eu-central-1,576,477,99,AWS 0256 MB
aws,go,256,eu-central-1,532,464,68,AWS 0256 MB
aws,go,256,eu-central-1,533,465,68,AWS 0256 MB
aws,go,256,eu-central-1,866,472,394,AWS 0256 MB
aws,go,256,eu-central-1,869,463,406,AWS 0256 MB
aws,go,256,eu-central-1,522,444,78,AWS 0256 MB
aws,go,256,eu-central-1,558,464,94,AWS 0256 MB
aws,go,256,eu-central-1,512,436,76,AWS 0256 MB
aws,go,256,eu-central-1,529,460,69,AWS 0256 MB
aws,go,256,eu-central-1,527,440,87,AWS 0256 MB
aws,go,256,eu-central-1,539,464,75,AWS 0256 MB
aws,go,256,eu-central-1,542,469,73,AWS 0256 MB
aws,go,256,eu-central-1,561,458,103,AWS 0256 MB
aws,go,256,eu-central-1,559,482,77,AWS 0256 MB
aws,go,256,eu-central-1,500,424,76,AWS 0256 MB
aws,go,256,eu-central-1,538,464,74,AWS 0256 MB
aws,go,256,eu-central-1,515,412,103,AWS 0256 MB
aws,go,256,eu-central-1,532,437,95,AWS 0256 MB
aws,go,256,eu-central-1,531,428,103,AWS 0256 MB
aws,go,256,eu-central-1,512,441,71,AWS 0256 MB
aws,go,256,eu-central-1,531,460,71,AWS 0256 MB
aws,go,256,eu-central-1,528,461,67,AWS 0256 MB
aws,go,256,eu-central-1,523,449,74,AWS 0256 MB
aws,go,256,eu-central-1,499,429,70,AWS 0256 MB
aws,go,256,eu-central-1,566,479,87,AWS 0256 MB
aws,go,256,eu-central-1,544,465,79,AWS 0256 MB
aws,go,256,eu-central-1,538,438,100,AWS 0256 MB
aws,go,256,eu-central-1,486,424,62,AWS 0256 MB
aws,go,256,eu-central-1,507,437,70,AWS 0256 MB
aws,go,256,eu-central-1,509,448,61,AWS 0256 MB
aws,go,256,eu-central-1,526,456,70,AWS 0256 MB
aws,go,256,eu-central-1,527,442,85,AWS 0256 MB
aws,go,256,eu-central-1,519,445,74,AWS 0256 MB
aws,go,256,eu-central-1,516,436,80,AWS 0256 MB
aws,go,256,eu-central-1,559,473,86,AWS 0256 MB
aws,go,256,eu-central-1,557,487,70,AWS 0256 MB
aws,go,256,eu-central-1,517,428,89,AWS 0256 MB
aws,go,256,eu-central-1,685,468,217,AWS 0256 MB
aws,go,256,eu-central-1,554,482,72,AWS 0256 MB
aws,go,256,eu-central-1,533,449,84,AWS 0256 MB
aws,go,256,eu-central-1,513,444,69,AWS 0256 MB
aws,go,256,eu-central-1,569,477,92,AWS 0256 MB
aws,go,256,eu-central-1,530,450,80,AWS 0256 MB
aws,go,256,eu-central-1,532,436,96,AWS 0256 MB
aws,go,256,eu-central-1,491,420,71,AWS 0256 MB
aws,go,256,eu-central-1,513,456,57,AWS 0256 MB
aws,go,256,eu-central-1,511,421,90,AWS 0256 MB
aws,go,256,eu-central-1,530,473,57,AWS 0256 MB
aws,go,256,eu-central-1,552,465,87,AWS 0256 MB
aws,go,256,eu-central-1,534,465,69,AWS 0256 MB
aws,go,256,eu-central-1,581,464,117,AWS 0256 MB
aws,go,256,eu-central-1,538,464,74,AWS 0256 MB
aws,go,256,eu-central-1,519,437,82,AWS 0256 MB
aws,go,256,eu-central-1,539,465,74,AWS 0256 MB
aws,go,256,eu-central-1,536,448,88,AWS 0256 MB
aws,go,256,eu-central-1,518,453,65,AWS 0256 MB
aws,go,256,eu-central-1,517,453,64,AWS 0256 MB
aws,go,256,eu-central-1,528,461,67,AWS 0256 MB
aws,go,256,eu-central-1,530,465,65,AWS 0256 MB
aws,go,256,eu-central-1,527,457,70,AWS 0256 MB
aws,go,256,eu-central-1,539,448,91,AWS 0256 MB
aws,go,256,eu-central-1,526,457,69,AWS 0256 MB
aws,go,256,eu-central-1,503,433,70,AWS 0256 MB
aws,go,256,eu-central-1,522,449,73,AWS 0256 MB
aws,go,256,eu-central-1,539,486,53,AWS 0256 MB
aws,go,256,eu-central-1,522,452,70,AWS 0256 MB
aws,go,256,eu-central-1,520,452,68,AWS 0256 MB
aws,go,256,eu-central-1,519,449,70,AWS 0256 MB
aws,go,256,eu-central-1,501,424,77,AWS 0256 MB
aws,go,256,eu-central-1,692,469,223,AWS 0256 MB
aws,go,256,eu-central-1,529,474,55,AWS 0256 MB
aws,go,256,eu-central-1,560,485,75,AWS 0256 MB
aws,go,256,eu-central-1,528,432,96,AWS 0256 MB
aws,go,256,eu-central-1,549,481,68,AWS 0256 MB
aws,go,256,eu-central-1,548,479,69,AWS 0256 MB
aws,go,256,eu-central-1,530,448,82,AWS 0256 MB
aws,go,256,eu-central-1,508,412,96,AWS 0256 MB
aws,go,256,eu-central-1,528,463,65,AWS 0256 MB
aws,go,256,eu-central-1,542,462,80,AWS 0256 MB
aws,go,256,eu-central-1,538,469,69,AWS 0256 MB
aws,go,256,eu-central-1,519,464,55,AWS 0256 MB
aws,go,256,eu-central-1,519,449,70,AWS 0256 MB
aws,go,256,eu-central-1,520,429,91,AWS 0256 MB
aws,go,256,eu-central-1,537,470,67,AWS 0256 MB
aws,go,256,eu-central-1,553,468,85,AWS 0256 MB
aws,go,256,eu-central-1,633,465,168,AWS 0256 MB
aws,go,256,eu-central-1,502,437,65,AWS 0256 MB
aws,go,512,eu-central-1,326,205,121,AWS 0512 MB
aws,go,512,eu-central-1,294,211,83,AWS 0512 MB
aws,go,512,eu-central-1,295,223,72,AWS 0512 MB
aws,go,512,eu-central-1,291,216,75,AWS 0512 MB
aws,go,512,eu-central-1,292,219,73,AWS 0512 MB
aws,go,512,eu-central-1,289,228,61,AWS 0512 MB
aws,go,512,eu-central-1,287,232,55,AWS 0512 MB
aws,go,512,eu-central-1,305,237,68,AWS 0512 MB
aws,go,512,eu-central-1,284,216,68,AWS 0512 MB
aws,go,512,eu-central-1,283,211,72,AWS 0512 MB
aws,go,512,eu-central-1,290,220,70,AWS 0512 MB
aws,go,512,eu-central-1,281,224,57,AWS 0512 MB
aws,go,512,eu-central-1,300,227,73,AWS 0512 MB
aws,go,512,eu-central-1,298,196,102,AWS 0512 MB
aws,go,512,eu-central-1,281,212,69,AWS 0512 MB
aws,go,512,eu-central-1,299,227,72,AWS 0512 MB
aws,go,512,eu-central-1,277,215,62,AWS 0512 MB
aws,go,512,eu-central-1,291,212,79,AWS 0512 MB
aws,go,512,eu-central-1,295,208,87,AWS 0512 MB
aws,go,512,eu-central-1,295,228,67,AWS 0512 MB
aws,go,512,eu-central-1,285,215,70,AWS 0512 MB
aws,go,512,eu-central-1,290,220,70,AWS 0512 MB
aws,go,512,eu-central-1,293,220,73,AWS 0512 MB
aws,go,512,eu-central-1,310,216,94,AWS 0512 MB
aws,go,512,eu-central-1,289,224,65,AWS 0512 MB
aws,go,512,eu-central-1,323,235,88,AWS 0512 MB
aws,go,512,eu-central-1,336,228,108,AWS 0512 MB
aws,go,512,eu-central-1,304,223,81,AWS 0512 MB
aws,go,512,eu-central-1,281,224,57,AWS 0512 MB
aws,go,512,eu-central-1,299,224,75,AWS 0512 MB
aws,go,512,eu-central-1,314,235,79,AWS 0512 MB
aws,go,512,eu-central-1,299,224,75,AWS 0512 MB
aws,go,512,eu-central-1,310,219,91,AWS 0512 MB
aws,go,512,eu-central-1,312,232,80,AWS 0512 MB
aws,go,512,eu-central-1,295,227,68,AWS 0512 MB
aws,go,512,eu-central-1,294,227,67,AWS 0512 MB
aws,go,512,eu-central-1,311,215,96,AWS 0512 MB
aws,go,512,eu-central-1,312,215,97,AWS 0512 MB
aws,go,512,eu-central-1,330,220,110,AWS 0512 MB
aws,go,512,eu-central-1,290,231,59,AWS 0512 MB
aws,go,512,eu-central-1,303,215,88,AWS 0512 MB
aws,go,512,eu-central-1,284,211,73,AWS 0512 MB
aws,go,512,eu-central-1,282,227,55,AWS 0512 MB
aws,go,512,eu-central-1,304,228,76,AWS 0512 MB
aws,go,512,eu-central-1,437,212,225,AWS 0512 MB
aws,go,512,eu-central-1,299,228,71,AWS 0512 MB
aws,go,512,eu-central-1,313,235,78,AWS 0512 MB
aws,go,512,eu-central-1,726,220,506,AWS 0512 MB
aws,go,512,eu-central-1,299,228,71,AWS 0512 MB
aws,go,512,eu-central-1,314,228,86,AWS 0512 MB
aws,go,512,eu-central-1,295,220,75,AWS 0512 MB
aws,go,512,eu-central-1,293,228,65,AWS 0512 MB
aws,go,512,eu-central-1,470,231,239,AWS 0512 MB
aws,go,512,eu-central-1,294,216,78,AWS 0512 MB
aws,go,512,eu-central-1,293,228,65,AWS 0512 MB
aws,go,512,eu-central-1,295,228,67,AWS 0512 MB
aws,go,512,eu-central-1,469,223,246,AWS 0512 MB
aws,go,512,eu-central-1,287,215,72,AWS 0512 MB
aws,go,512,eu-central-1,271,211,60,AWS 0512 MB
aws,go,512,eu-central-1,310,228,82,AWS 0512 MB
aws,go,512,eu-central-1,291,223,68,AWS 0512 MB
aws,go,512,eu-central-1,295,211,84,AWS 0512 MB
aws,go,512,eu-central-1,312,219,93,AWS 0512 MB
aws,go,512,eu-central-1,279,216,63,AWS 0512 MB
aws,go,512,eu-central-1,301,220,81,AWS 0512 MB
aws,go,512,eu-central-1,289,217,72,AWS 0512 MB
aws,go,512,eu-central-1,291,227,64,AWS 0512 MB
aws,go,512,eu-central-1,295,227,68,AWS 0512 MB
aws,go,512,eu-central-1,298,223,75,AWS 0512 MB
aws,go,512,eu-central-1,277,212,65,AWS 0512 MB
aws,go,512,eu-central-1,293,220,73,AWS 0512 MB
aws,go,512,eu-central-1,284,214,70,AWS 0512 MB
aws,go,512,eu-central-1,486,228,258,AWS 0512 MB
aws,go,512,eu-central-1,314,224,90,AWS 0512 MB
aws,go,512,eu-central-1,287,217,70,AWS 0512 MB
aws,go,512,eu-central-1,283,220,63,AWS 0512 MB
aws,go,512,eu-central-1,284,216,68,AWS 0512 MB
aws,go,512,eu-central-1,282,199,83,AWS 0512 MB
aws,go,512,eu-central-1,682,211,471,AWS 0512 MB
aws,go,512,eu-central-1,306,223,83,AWS 0512 MB
aws,go,512,eu-central-1,577,221,356,AWS 0512 MB
aws,go,512,eu-central-1,300,224,76,AWS 0512 MB
aws,go,512,eu-central-1,317,232,85,AWS 0512 MB
aws,go,512,eu-central-1,297,229,68,AWS 0512 MB
aws,go,512,eu-central-1,295,224,71,AWS 0512 MB
aws,go,512,eu-central-1,294,232,62,AWS 0512 MB
aws,go,512,eu-central-1,295,229,66,AWS 0512 MB
aws,go,512,eu-central-1,304,216,88,AWS 0512 MB
aws,go,512,eu-central-1,275,217,58,AWS 0512 MB
aws,go,512,eu-central-1,295,212,83,AWS 0512 MB
aws,go,512,eu-central-1,299,228,71,AWS 0512 MB
aws,go,512,eu-central-1,271,211,60,AWS 0512 MB
aws,go,512,eu-central-1,678,228,450,AWS 0512 MB
aws,go,512,eu-central-1,311,232,79,AWS 0512 MB
aws,go,512,eu-central-1,299,227,72,AWS 0512 MB
aws,go,512,eu-central-1,271,216,55,AWS 0512 MB
aws,go,512,eu-central-1,291,216,75,AWS 0512 MB
aws,go,512,eu-central-1,290,211,79,AWS 0512 MB
aws,go,512,eu-central-1,288,220,68,AWS 0512 MB
aws,go,512,eu-central-1,269,211,58,AWS 0512 MB
aws,go,1024,eu-central-1,463,108,355,AWS 1024 MB
aws,go,1024,eu-central-1,180,104,76,AWS 1024 MB
aws,go,1024,eu-central-1,173,103,70,AWS 1024 MB
aws,go,1024,eu-central-1,178,91,87,AWS 1024 MB
aws,go,1024,eu-central-1,183,111,72,AWS 1024 MB
aws,go,1024,eu-central-1,188,107,81,AWS 1024 MB
aws,go,1024,eu-central-1,164,92,72,AWS 1024 MB
aws,go,1024,eu-central-1,165,95,70,AWS 1024 MB
aws,go,1024,eu-central-1,183,103,80,AWS 1024 MB
aws,go,1024,eu-central-1,182,103,79,AWS 1024 MB
aws,go,1024,eu-central-1,183,99,84,AWS 1024 MB
aws,go,1024,eu-central-1,175,106,69,AWS 1024 MB
aws,go,1024,eu-central-1,174,99,75,AWS 1024 MB
aws,go,1024,eu-central-1,225,106,119,AWS 1024 MB
aws,go,1024,eu-central-1,173,99,74,AWS 1024 MB
aws,go,1024,eu-central-1,184,107,77,AWS 1024 MB
aws,go,1024,eu-central-1,165,98,67,AWS 1024 MB
aws,go,1024,eu-central-1,198,107,91,AWS 1024 MB
aws,go,1024,eu-central-1,164,111,53,AWS 1024 MB
aws,go,1024,eu-central-1,195,103,92,AWS 1024 MB
aws,go,1024,eu-central-1,176,107,69,AWS 1024 MB
aws,go,1024,eu-central-1,176,107,69,AWS 1024 MB
aws,go,1024,eu-central-1,172,105,67,AWS 1024 MB
aws,go,1024,eu-central-1,177,111,66,AWS 1024 MB
aws,go,1024,eu-central-1,176,103,73,AWS 1024 MB
aws,go,1024,eu-central-1,181,99,82,AWS 1024 MB
aws,go,1024,eu-central-1,185,111,74,AWS 1024 MB
aws,go,1024,eu-central-1,194,107,87,AWS 1024 MB
aws,go,1024,eu-central-1,187,107,80,AWS 1024 MB
aws,go,1024,eu-central-1,181,99,82,AWS 1024 MB
aws,go,1024,eu-central-1,171,99,72,AWS 1024 MB
aws,go,1024,eu-central-1,185,111,74,AWS 1024 MB
aws,go,1024,eu-central-1,181,107,74,AWS 1024 MB
aws,go,1024,eu-central-1,178,107,71,AWS 1024 MB
aws,go,1024,eu-central-1,182,103,79,AWS 1024 MB
aws,go,1024,eu-central-1,192,107,85,AWS 1024 MB
aws,go,1024,eu-central-1,178,95,83,AWS 1024 MB
aws,go,1024,eu-central-1,169,103,66,AWS 1024 MB
aws,go,1024,eu-central-1,192,107,85,AWS 1024 MB
aws,go,1024,eu-central-1,179,106,73,AWS 1024 MB
aws,go,1024,eu-central-1,165,107,58,AWS 1024 MB
aws,go,1024,eu-central-1,170,99,71,AWS 1024 MB
aws,go,1024,eu-central-1,178,107,71,AWS 1024 MB
aws,go,1024,eu-central-1,179,107,72,AWS 1024 MB
aws,go,1024,eu-central-1,179,106,73,AWS 1024 MB
aws,go,1024,eu-central-1,182,99,83,AWS 1024 MB
aws,go,1024,eu-central-1,177,96,81,AWS 1024 MB
aws,go,1024,eu-central-1,163,96,67,AWS 1024 MB
aws,go,1024,eu-central-1,177,107,70,AWS 1024 MB
aws,go,1024,eu-central-1,177,103,74,AWS 1024 MB
aws,go,1024,eu-central-1,422,107,315,AWS 1024 MB
aws,go,1024,eu-central-1,173,106,67,AWS 1024 MB
aws,go,1024,eu-central-1,179,95,84,AWS 1024 MB
aws,go,1024,eu-central-1,170,94,76,AWS 1024 MB
aws,go,1024,eu-central-1,185,112,73,AWS 1024 MB
aws,go,1024,eu-central-1,173,99,74,AWS 1024 MB
aws,go,1024,eu-central-1,166,100,66,AWS 1024 MB
aws,go,1024,eu-central-1,189,104,85,AWS 1024 MB
aws,go,1024,eu-central-1,168,100,68,AWS 1024 MB
aws,go,1024,eu-central-1,186,103,83,AWS 1024 MB
aws,go,1024,eu-central-1,182,112,70,AWS 1024 MB
aws,go,1024,eu-central-1,166,99,67,AWS 1024 MB
aws,go,1024,eu-central-1,182,108,74,AWS 1024 MB
aws,go,1024,eu-central-1,182,99,83,AWS 1024 MB
aws,go,1024,eu-central-1,158,96,62,AWS 1024 MB
aws,go,1024,eu-central-1,180,99,81,AWS 1024 MB
aws,go,1024,eu-central-1,180,100,80,AWS 1024 MB
aws,go,1024,eu-central-1,178,107,71,AWS 1024 MB
aws,go,1024,eu-central-1,188,95,93,AWS 1024 MB
aws,go,1024,eu-central-1,174,95,79,AWS 1024 MB
aws,go,1024,eu-central-1,175,108,67,AWS 1024 MB
aws,go,1024,eu-central-1,176,100,76,AWS 1024 MB
aws,go,1024,eu-central-1,645,107,538,AWS 1024 MB
aws,go,1024,eu-central-1,188,99,89,AWS 1024 MB
aws,go,1024,eu-central-1,165,107,58,AWS 1024 MB
aws,go,1024,eu-central-1,188,99,89,AWS 1024 MB
aws,go,1024,eu-central-1,185,104,81,AWS 1024 MB
aws,go,1024,eu-central-1,180,107,73,AWS 1024 MB
aws,go,1024,eu-central-1,179,107,72,AWS 1024 MB
aws,go,1024,eu-central-1,159,95,64,AWS 1024 MB
aws,go,1024,eu-central-1,180,103,77,AWS 1024 MB
aws,go,1024,eu-central-1,183,104,79,AWS 1024 MB
aws,go,1024,eu-central-1,179,107,72,AWS 1024 MB
aws,go,1024,eu-central-1,175,111,64,AWS 1024 MB
aws,go,1024,eu-central-1,179,107,72,AWS 1024 MB
aws,go,1024,eu-central-1,202,107,95,AWS 1024 MB
aws,go,1024,eu-central-1,152,99,53,AWS 1024 MB
aws,go,1024,eu-central-1,180,103,77,AWS 1024 MB
aws,go,1024,eu-central-1,230,107,123,AWS 1024 MB
aws,go,1024,eu-central-1,176,107,69,AWS 1024 MB
aws,go,1024,eu-central-1,175,104,71,AWS 1024 MB
aws,go,1024,eu-central-1,175,103,72,AWS 1024 MB
aws,go,1024,eu-central-1,178,107,71,AWS 1024 MB
aws,go,1024,eu-central-1,175,107,68,AWS 1024 MB
aws,go,1024,eu-central-1,177,103,74,AWS 1024 MB
aws,go,1024,eu-central-1,172,103,69,AWS 1024 MB
aws,go,1024,eu-central-1,191,107,84,AWS 1024 MB
aws,go,1024,eu-central-1,364,107,257,AWS 1024 MB
aws,go,1024,eu-central-1,182,95,87,AWS 1024 MB
aws,go,1024,eu-central-1,166,97,69,AWS 1024 MB
aws,go,2048,eu-central-1,175,70,105,AWS 2048 MB
aws,go,2048,eu-central-1,123,63,60,AWS 2048 MB
aws,go,2048,eu-central-1,143,63,80,AWS 2048 MB
aws,go,2048,eu-central-1,117,63,54,AWS 2048 MB
aws,go,2048,eu-central-1,136,63,73,AWS 2048 MB
aws,go,2048,eu-central-1,139,63,76,AWS 2048 MB
aws,go,2048,eu-central-1,120,63,57,AWS 2048 MB
aws,go,2048,eu-central-1,118,63,55,AWS 2048 MB
aws,go,2048,eu-central-1,118,63,55,AWS 2048 MB
aws,go,2048,eu-central-1,125,64,61,AWS 2048 MB
aws,go,2048,eu-central-1,147,63,84,AWS 2048 MB
aws,go,2048,eu-central-1,129,63,66,AWS 2048 MB
aws,go,2048,eu-central-1,147,63,84,AWS 2048 MB
aws,go,2048,eu-central-1,129,63,66,AWS 2048 MB
aws,go,2048,eu-central-1,129,63,66,AWS 2048 MB
aws,go,2048,eu-central-1,124,62,62,AWS 2048 MB
aws,go,2048,eu-central-1,122,63,59,AWS 2048 MB
aws,go,2048,eu-central-1,121,63,58,AWS 2048 MB
aws,go,2048,eu-central-1,124,63,61,AWS 2048 MB
aws,go,2048,eu-central-1,133,63,70,AWS 2048 MB
aws,go,2048,eu-central-1,148,63,85,AWS 2048 MB
aws,go,2048,eu-central-1,121,63,58,AWS 2048 MB
aws,go,2048,eu-central-1,123,63,60,AWS 2048 MB
aws,go,2048,eu-central-1,138,63,75,AWS 2048 MB
aws,go,2048,eu-central-1,130,63,67,AWS 2048 MB
aws,go,2048,eu-central-1,153,63,90,AWS 2048 MB
aws,go,2048,eu-central-1,124,62,62,AWS 2048 MB
aws,go,2048,eu-central-1,118,63,55,AWS 2048 MB
aws,go,2048,eu-central-1,120,63,57,AWS 2048 MB
aws,go,2048,eu-central-1,124,63,61,AWS 2048 MB
aws,go,2048,eu-central-1,119,63,56,AWS 2048 MB
aws,go,2048,eu-central-1,130,63,67,AWS 2048 MB
aws,go,2048,eu-central-1,128,63,65,AWS 2048 MB
aws,go,2048,eu-central-1,127,63,64,AWS 2048 MB
aws,go,2048,eu-central-1,123,63,60,AWS 2048 MB
aws,go,2048,eu-central-1,126,63,63,AWS 2048 MB
aws,go,2048,eu-central-1,139,63,76,AWS 2048 MB
aws,go,2048,eu-central-1,144,66,78,AWS 2048 MB
aws,go,2048,eu-central-1,126,63,63,AWS 2048 MB
aws,go,2048,eu-central-1,140,65,75,AWS 2048 MB
aws,go,2048,eu-central-1,124,63,61,AWS 2048 MB
aws,go,2048,eu-central-1,127,63,64,AWS 2048 MB
aws,go,2048,eu-central-1,116,63,53,AWS 2048 MB
aws,go,2048,eu-central-1,137,62,75,AWS 2048 MB
aws,go,2048,eu-central-1,138,63,75,AWS 2048 MB
aws,go,2048,eu-central-1,142,63,79,AWS 2048 MB
aws,go,2048,eu-central-1,119,63,56,AWS 2048 MB
aws,go,2048,eu-central-1,126,63,63,AWS 2048 MB
aws,go,2048,eu-central-1,126,63,63,AWS 2048 MB
aws,go,2048,eu-central-1,149,63,86,AWS 2048 MB
aws,go,2048,eu-central-1,127,63,64,AWS 2048 MB
aws,go,2048,eu-central-1,120,63,57,AWS 2048 MB
aws,go,2048,eu-central-1,122,63,59,AWS 2048 MB
aws,go,2048,eu-central-1,126,63,63,AWS 2048 MB
aws,go,2048,eu-central-1,128,63,65,AWS 2048 MB
aws,go,2048,eu-central-1,132,63,69,AWS 2048 MB
aws,go,2048,eu-central-1,140,62,78,AWS 2048 MB
aws,go,2048,eu-central-1,120,63,57,AWS 2048 MB
aws,go,2048,eu-central-1,142,63,79,AWS 2048 MB
aws,go,2048,eu-central-1,152,65,87,AWS 2048 MB
aws,go,2048,eu-central-1,148,63,85,AWS 2048 MB
aws,go,2048,eu-central-1,619,63,556,AWS 2048 MB
aws,go,2048,eu-central-1,134,62,72,AWS 2048 MB
aws,go,2048,eu-central-1,129,62,67,AWS 2048 MB
aws,go,2048,eu-central-1,137,63,74,AWS 2048 MB
aws,go,2048,eu-central-1,125,62,63,AWS 2048 MB
aws,go,2048,eu-central-1,117,63,54,AWS 2048 MB
aws,go,2048,eu-central-1,128,63,65,AWS 2048 MB
aws,go,2048,eu-central-1,126,63,63,AWS 2048 MB
aws,go,2048,eu-central-1,140,62,78,AWS 2048 MB
aws,go,2048,eu-central-1,136,62,74,AWS 2048 MB
aws,go,2048,eu-central-1,129,62,67,AWS 2048 MB
aws,go,2048,eu-central-1,129,62,67,AWS 2048 MB
aws,go,2048,eu-central-1,122,63,59,AWS 2048 MB
aws,go,2048,eu-central-1,142,63,79,AWS 2048 MB
aws,go,2048,eu-central-1,138,63,75,AWS 2048 MB
aws,go,2048,eu-central-1,215,62,153,AWS 2048 MB
aws,go,2048,eu-central-1,120,62,58,AWS 2048 MB
aws,go,2048,eu-central-1,139,68,71,AWS 2048 MB
aws,go,2048,eu-central-1,122,62,60,AWS 2048 MB
aws,go,2048,eu-central-1,156,63,93,AWS 2048 MB
aws,go,2048,eu-central-1,128,62,66,AWS 2048 MB
aws,go,2048,eu-central-1,170,62,108,AWS 2048 MB
aws,go,2048,eu-central-1,131,62,69,AWS 2048 MB
aws,go,2048,eu-central-1,127,62,65,AWS 2048 MB
aws,go,2048,eu-central-1,133,63,70,AWS 2048 MB
aws,go,2048,eu-central-1,134,63,71,AWS 2048 MB
aws,go,2048,eu-central-1,133,63,70,AWS 2048 MB
aws,go,2048,eu-central-1,134,63,71,AWS 2048 MB
aws,go,2048,eu-central-1,135,63,72,AWS 2048 MB
aws,go,2048,eu-central-1,116,63,53,AWS 2048 MB
aws,go,2048,eu-central-1,130,69,61,AWS 2048 MB
aws,go,2048,eu-central-1,145,63,82,AWS 2048 MB
aws,go,2048,eu-central-1,143,63,80,AWS 2048 MB
aws,go,2048,eu-central-1,120,63,57,AWS 2048 MB
aws,go,2048,eu-central-1,129,63,66,AWS 2048 MB
aws,go,2048,eu-central-1,133,63,70,AWS 2048 MB
aws,go,2048,eu-central-1,130,63,67,AWS 2048 MB
aws,go,2048,eu-central-1,130,63,67,AWS 2048 MB
aws,go,2048,eu-central-1,121,62,59,AWS 2048 MB
google,go,128,europe-west1,1328,1198,130,Google 0128 MB
google,go,128,europe-west1,1238,1096,142,Google 0128 MB
google,go,128,europe-west1,941,808,133,Google 0128 MB
google,go,128,europe-west1,1035,901,134,Google 0128 MB
google,go,128,europe-west1,1037,901,136,Google 0128 MB
google,go,128,europe-west1,933,847,86,Google 0128 MB
google,go,128,europe-west1,1028,956,72,Google 0128 MB
google,go,128,europe-west1,1125,1000,125,Google 0128 MB
google,go,128,europe-west1,1120,1000,120,Google 0128 MB
google,go,128,europe-west1,1021,904,117,Google 0128 MB
google,go,128,europe-west1,1121,908,213,Google 0128 MB
google,go,128,europe-west1,922,842,80,Google 0128 MB
google,go,128,europe-west1,1121,993,128,Google 0128 MB
google,go,128,europe-west1,1015,897,118,Google 0128 MB
google,go,128,europe-west1,1124,1002,122,Google 0128 MB
google,go,128,europe-west1,920,810,110,Google 0128 MB
google,go,128,europe-west1,1365,1207,158,Google 0128 MB
google,go,128,europe-west1,1114,1003,111,Google 0128 MB
google,go,128,europe-west1,1107,1001,106,Google 0128 MB
google,go,128,europe-west1,1109,1005,104,Google 0128 MB
google,go,128,europe-west1,1104,1032,72,Google 0128 MB
google,go,128,europe-west1,812,749,63,Google 0128 MB
google,go,128,europe-west1,1001,896,105,Google 0128 MB
google,go,128,europe-west1,1007,907,100,Google 0128 MB
google,go,128,europe-west1,1001,927,74,Google 0128 MB
google,go,128,europe-west1,1115,1008,107,Google 0128 MB
google,go,128,europe-west1,1091,996,95,Google 0128 MB
google,go,128,europe-west1,993,921,72,Google 0128 MB
google,go,128,europe-west1,992,894,98,Google 0128 MB
google,go,128,europe-west1,993,840,153,Google 0128 MB
google,go,128,europe-west1,988,902,86,Google 0128 MB
google,go,128,europe-west1,1185,997,188,Google 0128 MB
google,go,128,europe-west1,1339,1209,130,Google 0128 MB
google,go,128,europe-west1,1083,1002,81,Google 0128 MB
google,go,128,europe-west1,1178,1096,82,Google 0128 MB
google,go,128,europe-west1,1424,1000,424,Google 0128 MB
google,go,128,europe-west1,1075,995,80,Google 0128 MB
google,go,128,europe-west1,1321,1192,129,Google 0128 MB
google,go,128,europe-west1,984,808,176,Google 0128 MB
google,go,128,europe-west1,1083,1006,77,Google 0128 MB
google,go,128,europe-west1,980,905,75,Google 0128 MB
google,go,128,europe-west1,1082,908,174,Google 0128 MB
google,go,128,europe-west1,1075,1004,71,Google 0128 MB
google,go,128,europe-west1,970,892,78,Google 0128 MB
google,go,128,europe-west1,1267,1003,264,Google 0128 MB
google,go,128,europe-west1,1161,993,168,Google 0128 MB
google,go,128,europe-west1,1069,990,79,Google 0128 MB
google,go,128,europe-west1,1161,997,164,Google 0128 MB
google,go,128,europe-west1,1272,1107,165,Google 0128 MB
google,go,128,europe-west1,1064,905,159,Google 0128 MB
google,go,128,europe-west1,1406,1206,200,Google 0128 MB
google,go,128,europe-west1,1158,993,165,Google 0128 MB
google,go,128,europe-west1,1056,963,93,Google 0128 MB
google,go,128,europe-west1,1162,1004,158,Google 0128 MB
google,go,128,europe-west1,1058,898,160,Google 0128 MB
google,go,128,europe-west1,962,897,65,Google 0128 MB
google,go,128,europe-west1,1057,896,161,Google 0128 MB
google,go,128,europe-west1,1145,985,160,Google 0128 MB
google,go,128,europe-west1,1149,1079,70,Google 0128 MB
google,go,128,europe-west1,1153,1008,145,Google 0128 MB
google,go,128,europe-west1,1250,900,350,Google 0128 MB
google,go,128,europe-west1,1119,906,213,Google 0128 MB
google,go,128,europe-west1,1024,946,78,Google 0128 MB
google,go,128,europe-west1,1128,907,221,Google 0128 MB
google,go,128,europe-west1,1229,1105,124,Google 0128 MB
google,go,128,europe-west1,1024,897,127,Google 0128 MB
google,go,128,europe-west1,1122,1050,72,Google 0128 MB
google,go,128,europe-west1,1023,906,117,Google 0128 MB
google,go,128,europe-west1,915,839,76,Google 0128 MB
google,go,128,europe-west1,924,805,119,Google 0128 MB
google,go,128,europe-west1,1013,894,119,Google 0128 MB
google,go,128,europe-west1,1018,901,117,Google 0128 MB
google,go,128,europe-west1,1022,803,219,Google 0128 MB
google,go,128,europe-west1,1016,902,114,Google 0128 MB
google,go,128,europe-west1,1107,1000,107,Google 0128 MB
google,go,128,europe-west1,1109,990,119,Google 0128 MB
google,go,128,europe-west1,1018,910,108,Google 0128 MB
google,go,128,europe-west1,1262,844,418,Google 0128 MB
google,go,128,europe-west1,1110,994,116,Google 0128 MB
google,go,128,europe-west1,1101,950,151,Google 0128 MB
google,go,128,europe-west1,1106,1041,65,Google 0128 MB
google,go,128,europe-west1,1444,1287,157,Google 0128 MB
google,go,128,europe-west1,1452,1209,243,Google 0128 MB
google,go,128,europe-west1,994,927,67,Google 0128 MB
google,go,128,europe-west1,1092,1002,90,Google 0128 MB
google,go,128,europe-west1,1092,1004,88,Google 0128 MB
google,go,128,europe-west1,996,908,88,Google 0128 MB
google,go,128,europe-west1,1093,1005,88,Google 0128 MB
google,go,128,europe-west1,1087,1024,63,Google 0128 MB
google,go,128,europe-west1,984,904,80,Google 0128 MB
google,go,128,europe-west1,1181,1098,83,Google 0128 MB
google,go,128,europe-west1,996,902,94,Google 0128 MB
google,go,128,europe-west1,997,898,99,Google 0128 MB
google,go,128,europe-west1,796,725,71,Google 0128 MB
google,go,128,europe-west1,1093,1000,93,Google 0128 MB
google,go,128,europe-west1,1086,900,186,Google 0128 MB
google,go,128,europe-west1,1098,1008,90,Google 0128 MB
google,go,128,europe-west1,1290,1194,96,Google 0128 MB
google,go,128,europe-west1,1045,951,94,Google 0128 MB
google,go,128,europe-west1,795,733,62,Google 0128 MB
google,go,256,europe-west1,515,396,119,Google 0256 MB
google,go,256,europe-west1,532,409,123,Google 0256 MB
google,go,256,europe-west1,532,413,119,Google 0256 MB
google,go,256,europe-west1,527,409,118,Google 0256 MB
google,go,256,europe-west1,412,354,58,Google 0256 MB
google,go,256,europe-west1,518,405,113,Google 0256 MB
google,go,256,europe-west1,516,406,110,Google 0256 MB
google,go,256,europe-west1,416,318,98,Google 0256 MB
google,go,256,europe-west1,512,405,107,Google 0256 MB
google,go,256,europe-west1,516,410,106,Google 0256 MB
google,go,256,europe-west1,412,345,67,Google 0256 MB
google,go,256,europe-west1,515,408,107,Google 0256 MB
google,go,256,europe-west1,512,408,104,Google 0256 MB
google,go,256,europe-west1,506,402,104,Google 0256 MB
google,go,256,europe-west1,431,362,69,Google 0256 MB
google,go,256,europe-west1,519,412,107,Google 0256 MB
google,go,256,europe-west1,707,319,388,Google 0256 MB
google,go,256,europe-west1,495,410,85,Google 0256 MB
google,go,256,europe-west1,493,405,88,Google 0256 MB
google,go,256,europe-west1,398,321,77,Google 0256 MB
google,go,256,europe-west1,681,600,81,Google 0256 MB
google,go,256,europe-west1,576,497,79,Google 0256 MB
google,go,256,europe-west1,399,327,72,Google 0256 MB
google,go,256,europe-west1,489,419,70,Google 0256 MB
google,go,256,europe-west1,477,409,68,Google 0256 MB
google,go,256,europe-west1,397,338,59,Google 0256 MB
google,go,256,europe-west1,492,415,77,Google 0256 MB
google,go,256,europe-west1,494,405,89,Google 0256 MB
google,go,256,europe-west1,564,410,154,Google 0256 MB
google,go,256,europe-west1,470,405,65,Google 0256 MB
google,go,256,europe-west1,565,401,164,Google 0256 MB
google,go,256,europe-west1,575,405,170,Google 0256 MB
google,go,256,europe-west1,573,414,159,Google 0256 MB
google,go,256,europe-west1,574,414,160,Google 0256 MB
google,go,256,europe-west1,457,400,57,Google 0256 MB
google,go,256,europe-west1,460,397,63,Google 0256 MB
google,go,256,europe-west1,474,389,85,Google 0256 MB
google,go,256,europe-west1,577,417,160,Google 0256 MB
google,go,256,europe-west1,565,398,167,Google 0256 MB
google,go,256,europe-west1,554,479,75,Google 0256 MB
google,go,256,europe-west1,537,401,136,Google 0256 MB
google,go,256,europe-west1,437,377,60,Google 0256 MB
google,go,256,europe-west1,536,475,61,Google 0256 MB
google,go,256,europe-west1,439,378,61,Google 0256 MB
google,go,256,europe-west1,535,404,131,Google 0256 MB
google,go,256,europe-west1,632,502,130,Google 0256 MB
google,go,256,europe-west1,627,509,118,Google 0256 MB
google,go,256,europe-west1,531,417,114,Google 0256 MB
google,go,256,europe-west1,415,355,60,Google 0256 MB
google,go,256,europe-west1,511,409,102,Google 0256 MB
google,go,256,europe-west1,689,403,286,Google 0256 MB
google,go,256,europe-west1,506,405,101,Google 0256 MB
google,go,256,europe-west1,405,345,60,Google 0256 MB
google,go,256,europe-west1,510,411,99,Google 0256 MB
google,go,256,europe-west1,404,348,56,Google 0256 MB
google,go,256,europe-west1,595,498,97,Google 0256 MB
google,go,256,europe-west1,518,406,112,Google 0256 MB
google,go,256,europe-west1,514,411,103,Google 0256 MB
google,go,256,europe-west1,413,352,61,Google 0256 MB
google,go,256,europe-west1,413,359,54,Google 0256 MB
google,go,256,europe-west1,510,411,99,Google 0256 MB
google,go,256,europe-west1,501,440,61,Google 0256 MB
google,go,256,europe-west1,500,404,96,Google 0256 MB
google,go,256,europe-west1,490,400,90,Google 0256 MB
google,go,256,europe-west1,401,327,74,Google 0256 MB
google,go,256,europe-west1,487,399,88,Google 0256 MB
google,go,256,europe-west1,492,405,87,Google 0256 MB
google,go,256,europe-west1,487,405,82,Google 0256 MB
google,go,256,europe-west1,506,421,85,Google 0256 MB
google,go,256,europe-west1,404,344,60,Google 0256 MB
google,go,256,europe-west1,385,321,64,Google 0256 MB
google,go,256,europe-west1,488,407,81,Google 0256 MB
google,go,256,europe-west1,486,412,74,Google 0256 MB
google,go,256,europe-west1,490,318,172,Google 0256 MB
google,go,256,europe-west1,480,407,73,Google 0256 MB
google,go,256,europe-west1,569,498,71,Google 0256 MB
google,go,256,europe-west1,480,414,66,Google 0256 MB
google,go,256,europe-west1,377,317,60,Google 0256 MB
google,go,256,europe-west1,502,428,74,Google 0256 MB
google,go,256,europe-west1,485,413,72,Google 0256 MB
google,go,256,europe-west1,493,419,74,Google 0256 MB
google,go,256,europe-west1,475,402,73,Google 0256 MB
google,go,256,europe-west1,697,414,283,Google 0256 MB
google,go,256,europe-west1,436,377,59,Google 0256 MB
google,go,256,europe-west1,621,504,117,Google 0256 MB
google,go,256,europe-west1,519,456,63,Google 0256 MB
google,go,256,europe-west1,603,506,97,Google 0256 MB
google,go,256,europe-west1,488,394,94,Google 0256 MB
google,go,256,europe-west1,573,494,79,Google 0256 MB
google,go,256,europe-west1,381,322,59,Google 0256 MB
google,go,256,europe-west1,482,404,78,Google 0256 MB
google,go,256,europe-west1,573,502,71,Google 0256 MB
google,go,256,europe-west1,573,505,68,Google 0256 MB
google,go,256,europe-west1,365,304,61,Google 0256 MB
google,go,256,europe-west1,468,410,58,Google 0256 MB
google,go,256,europe-west1,581,413,168,Google 0256 MB
google,go,256,europe-west1,474,410,64,Google 0256 MB
google,go,256,europe-west1,473,408,65,Google 0256 MB
google,go,256,europe-west1,672,408,264,Google 0256 MB
google,go,256,europe-west1,571,420,151,Google 0256 MB
google,go,512,europe-west1,266,178,88,Google 0512 MB
google,go,512,europe-west1,246,176,70,Google 0512 MB
google,go,512,europe-west1,244,177,67,Google 0512 MB
google,go,512,europe-west1,248,181,67,Google 0512 MB
google,go,512,europe-west1,259,197,62,Google 0512 MB
google,go,512,europe-west1,350,219,131,Google 0512 MB
google,go,512,europe-west1,250,173,77,Google 0512 MB
google,go,512,europe-west1,349,222,127,Google 0512 MB
google,go,512,europe-west1,343,209,134,Google 0512 MB
google,go,512,europe-west1,344,216,128,Google 0512 MB
google,go,512,europe-west1,257,191,66,Google 0512 MB
google,go,512,europe-west1,233,173,60,Google 0512 MB
google,go,512,europe-west1,246,174,72,Google 0512 MB
google,go,512,europe-west1,351,221,130,Google 0512 MB
google,go,512,europe-west1,377,253,124,Google 0512 MB
google,go,512,europe-west1,232,164,68,Google 0512 MB
google,go,512,europe-west1,342,222,120,Google 0512 MB
google,go,512,europe-west1,224,161,63,Google 0512 MB
google,go,512,europe-west1,345,222,123,Google 0512 MB
google,go,512,europe-west1,332,213,119,Google 0512 MB
google,go,512,europe-west1,260,203,57,Google 0512 MB
google,go,512,europe-west1,461,370,91,Google 0512 MB
google,go,512,europe-west1,423,265,158,Google 0512 MB
google,go,512,europe-west1,292,209,83,Google 0512 MB
google,go,512,europe-west1,296,227,69,Google 0512 MB
google,go,512,europe-west1,379,220,159,Google 0512 MB
google,go,512,europe-west1,274,192,82,Google 0512 MB
google,go,512,europe-west1,266,194,72,Google 0512 MB
google,go,512,europe-west1,372,213,159,Google 0512 MB
google,go,512,europe-west1,390,248,142,Google 0512 MB
google,go,512,europe-west1,298,225,73,Google 0512 MB
google,go,512,europe-west1,445,297,148,Google 0512 MB
google,go,512,europe-west1,399,296,103,Google 0512 MB
google,go,512,europe-west1,450,360,90,Google 0512 MB
google,go,512,europe-west1,397,264,133,Google 0512 MB
google,go,512,europe-west1,385,218,167,Google 0512 MB
google,go,512,europe-west1,372,219,153,Google 0512 MB
google,go,512,europe-west1,367,219,148,Google 0512 MB
google,go,512,europe-west1,260,192,68,Google 0512 MB
google,go,512,europe-west1,349,288,61,Google 0512 MB
google,go,512,europe-west1,384,250,134,Google 0512 MB
google,go,512,europe-west1,260,202,58,Google 0512 MB
google,go,512,europe-west1,371,242,129,Google 0512 MB
google,go,512,europe-west1,338,202,136,Google 0512 MB
google,go,512,europe-west1,433,172,261,Google 0512 MB
google,go,512,europe-west1,235,168,67,Google 0512 MB
google,go,512,europe-west1,393,273,120,Google 0512 MB
google,go,512,europe-west1,725,241,484,Google 0512 MB
google,go,512,europe-west1,338,210,128,Google 0512 MB
google,go,512,europe-west1,356,230,126,Google 0512 MB
google,go,512,europe-west1,241,178,63,Google 0512 MB
google,go,512,europe-west1,248,187,61,Google 0512 MB
google,go,512,europe-west1,442,215,227,Google 0512 MB
google,go,512,europe-west1,276,207,69,Google 0512 MB
google,go,512,europe-west1,344,212,132,Google 0512 MB
google,go,512,europe-west1,339,219,120,Google 0512 MB
google,go,512,europe-west1,537,221,316,Google 0512 MB
google,go,512,europe-west1,337,211,126,Google 0512 MB
google,go,512,europe-west1,250,189,61,Google 0512 MB
google,go,512,europe-west1,244,169,75,Google 0512 MB
google,go,512,europe-west1,350,234,116,Google 0512 MB
google,go,512,europe-west1,324,218,106,Google 0512 MB
google,go,512,europe-west1,232,160,72,Google 0512 MB
google,go,512,europe-west1,248,176,72,Google 0512 MB
google,go,512,europe-west1,238,173,65,Google 0512 MB
google,go,512,europe-west1,298,191,107,Google 0512 MB
google,go,512,europe-west1,347,248,99,Google 0512 MB
google,go,512,europe-west1,286,195,91,Google 0512 MB
google,go,512,europe-west1,227,161,66,Google 0512 MB
google,go,512,europe-west1,291,205,86,Google 0512 MB
google,go,512,europe-west1,283,218,65,Google 0512 MB
google,go,512,europe-west1,252,186,66,Google 0512 MB
google,go,512,europe-west1,505,224,281,Google 0512 MB
google,go,512,europe-west1,414,235,179,Google 0512 MB
google,go,512,europe-west1,225,163,62,Google 0512 MB
google,go,512,europe-west1,299,219,80,Google 0512 MB
google,go,512,europe-west1,352,257,95,Google 0512 MB
google,go,512,europe-west1,295,198,97,Google 0512 MB
google,go,512,europe-west1,813,234,579,Google 0512 MB
google,go,512,europe-west1,335,261,74,Google 0512 MB
google,go,512,europe-west1,599,206,393,Google 0512 MB
google,go,512,europe-west1,285,215,70,Google 0512 MB
google,go,512,europe-west1,286,212,74,Google 0512 MB
google,go,512,europe-west1,298,215,83,Google 0512 MB
google,go,512,europe-west1,295,218,77,Google 0512 MB
google,go,512,europe-west1,365,196,169,Google 0512 MB
google,go,512,europe-west1,405,232,173,Google 0512 MB
google,go,512,europe-west1,380,217,163,Google 0512 MB
google,go,512,europe-west1,384,322,62,Google 0512 MB
google,go,512,europe-west1,412,244,168,Google 0512 MB
google,go,512,europe-west1,374,219,155,Google 0512 MB
google,go,512,europe-west1,294,210,84,Google 0512 MB
google,go,512,europe-west1,677,200,477,Google 0512 MB
google,go,512,europe-west1,377,234,143,Google 0512 MB
google,go,512,europe-west1,275,203,72,Google 0512 MB
google,go,512,europe-west1,391,239,152,Google 0512 MB
google,go,512,europe-west1,370,223,147,Google 0512 MB
google,go,512,europe-west1,278,209,69,Google 0512 MB
google,go,512,europe-west1,361,226,135,Google 0512 MB
google,go,512,europe-west1,354,219,135,Google 0512 MB
google,go,1024,europe-west1,157,90,67,Google 1024 MB
google,go,1024,europe-west1,150,77,73,Google 1024 MB
google,go,1024,europe-west1,167,102,65,Google 1024 MB
google,go,1024,europe-west1,153,89,64,Google 1024 MB
google,go,1024,europe-west1,157,96,61,Google 1024 MB
google,go,1024,europe-west1,159,90,69,Google 1024 MB
google,go,1024,europe-west1,198,129,69,Google 1024 MB
google,go,1024,europe-west1,181,115,66,Google 1024 MB
google,go,1024,europe-west1,174,102,72,Google 1024 MB
google,go,1024,europe-west1,175,118,57,Google 1024 MB
google,go,1024,europe-west1,159,95,64,Google 1024 MB
google,go,1024,europe-west1,140,79,61,Google 1024 MB
google,go,1024,europe-west1,195,118,77,Google 1024 MB
google,go,1024,europe-west1,169,103,66,Google 1024 MB
google,go,1024,europe-west1,154,86,68,Google 1024 MB
google,go,1024,europe-west1,207,123,84,Google 1024 MB
google,go,1024,europe-west1,192,119,73,Google 1024 MB
google,go,1024,europe-west1,192,109,83,Google 1024 MB
google,go,1024,europe-west1,222,137,85,Google 1024 MB
google,go,1024,europe-west1,182,94,88,Google 1024 MB
google,go,1024,europe-west1,193,122,71,Google 1024 MB
google,go,1024,europe-west1,181,117,64,Google 1024 MB
google,go,1024,europe-west1,186,113,73,Google 1024 MB
google,go,1024,europe-west1,152,93,59,Google 1024 MB
google,go,1024,europe-west1,177,113,64,Google 1024 MB
google,go,1024,europe-west1,168,109,59,Google 1024 MB
google,go,1024,europe-west1,218,140,78,Google 1024 MB
google,go,1024,europe-west1,197,130,67,Google 1024 MB
google,go,1024,europe-west1,190,102,88,Google 1024 MB
google,go,1024,europe-west1,193,132,61,Google 1024 MB
google,go,1024,europe-west1,177,118,59,Google 1024 MB
google,go,1024,europe-west1,198,128,70,Google 1024 MB
google,go,1024,europe-west1,208,128,80,Google 1024 MB
google,go,1024,europe-west1,168,110,58,Google 1024 MB
google,go,1024,europe-west1,175,113,62,Google 1024 MB
google,go,1024,europe-west1,170,110,60,Google 1024 MB
google,go,1024,europe-west1,167,93,74,Google 1024 MB
google,go,1024,europe-west1,160,99,61,Google 1024 MB
google,go,1024,europe-west1,264,120,144,Google 1024 MB
google,go,1024,europe-west1,260,118,142,Google 1024 MB
google,go,1024,europe-west1,152,86,66,Google 1024 MB
google,go,1024,europe-west1,173,108,65,Google 1024 MB
google,go,1024,europe-west1,246,113,133,Google 1024 MB
google,go,1024,europe-west1,167,98,69,Google 1024 MB
google,go,1024,europe-west1,155,97,58,Google 1024 MB
google,go,1024,europe-west1,261,127,134,Google 1024 MB
google,go,1024,europe-west1,165,106,59,Google 1024 MB
google,go,1024,europe-west1,179,112,67,Google 1024 MB
google,go,1024,europe-west1,184,118,66,Google 1024 MB
google,go,1024,europe-west1,172,112,60,Google 1024 MB
google,go,1024,europe-west1,275,142,133,Google 1024 MB
google,go,1024,europe-west1,171,110,61,Google 1024 MB
google,go,1024,europe-west1,386,100,286,Google 1024 MB
google,go,1024,europe-west1,251,126,125,Google 1024 MB
google,go,1024,europe-west1,241,114,127,Google 1024 MB
google,go,1024,europe-west1,240,118,122,Google 1024 MB
google,go,1024,europe-west1,180,102,78,Google 1024 MB
google,go,1024,europe-west1,235,117,118,Google 1024 MB
google,go,1024,europe-west1,231,113,118,Google 1024 MB
google,go,1024,europe-west1,160,99,61,Google 1024 MB
google,go,1024,europe-west1,243,124,119,Google 1024 MB
google,go,1024,europe-west1,147,86,61,Google 1024 MB
google,go,1024,europe-west1,189,119,70,Google 1024 MB
google,go,1024,europe-west1,166,112,54,Google 1024 MB
google,go,1024,europe-west1,135,77,58,Google 1024 MB
google,go,1024,europe-west1,170,107,63,Google 1024 MB
google,go,1024,europe-west1,147,88,59,Google 1024 MB
google,go,1024,europe-west1,277,194,83,Google 1024 MB
google,go,1024,europe-west1,173,100,73,Google 1024 MB
google,go,1024,europe-west1,152,88,64,Google 1024 MB
google,go,1024,europe-west1,166,101,65,Google 1024 MB
google,go,1024,europe-west1,148,92,56,Google 1024 MB
google,go,1024,europe-west1,346,279,67,Google 1024 MB
google,go,1024,europe-west1,421,273,148,Google 1024 MB
google,go,1024,europe-west1,170,108,62,Google 1024 MB
google,go,1024,europe-west1,209,131,78,Google 1024 MB
google,go,1024,europe-west1,389,277,112,Google 1024 MB
google,go,1024,europe-west1,237,119,118,Google 1024 MB
google,go,1024,europe-west1,165,101,64,Google 1024 MB
google,go,1024,europe-west1,247,136,111,Google 1024 MB
google,go,1024,europe-west1,241,129,112,Google 1024 MB
google,go,1024,europe-west1,165,107,58,Google 1024 MB
google,go,1024,europe-west1,162,98,64,Google 1024 MB
google,go,1024,europe-west1,224,110,114,Google 1024 MB
google,go,1024,europe-west1,166,97,69,Google 1024 MB
google,go,1024,europe-west1,225,118,107,Google 1024 MB
google,go,1024,europe-west1,160,93,67,Google 1024 MB
google,go,1024,europe-west1,317,219,98,Google 1024 MB
google,go,1024,europe-west1,251,144,107,Google 1024 MB
google,go,1024,europe-west1,232,124,108,Google 1024 MB
google,go,1024,europe-west1,152,88,64,Google 1024 MB
google,go,1024,europe-west1,229,125,104,Google 1024 MB
google,go,1024,europe-west1,238,135,103,Google 1024 MB
google,go,1024,europe-west1,155,94,61,Google 1024 MB
google,go,1024,europe-west1,183,119,64,Google 1024 MB
google,go,1024,europe-west1,230,130,100,Google 1024 MB
google,go,1024,europe-west1,166,104,62,Google 1024 MB
google,go,1024,europe-west1,217,125,92,Google 1024 MB
google,go,1024,europe-west1,156,92,64,Google 1024 MB
google,go,1024,europe-west1,154,98,56,Google 1024 MB
google,go,2048,europe-west1,153,80,73,Google 2048 MB
google,go,2048,europe-west1,152,83,69,Google 2048 MB
google,go,2048,europe-west1,141,82,59,Google 2048 MB
google,go,2048,europe-west1,146,87,59,Google 2048 MB
google,go,2048,europe-west1,144,76,68,Google 2048 MB
google,go,2048,europe-west1,336,181,155,Google 2048 MB
google,go,2048,europe-west1,232,80,152,Google 2048 MB
google,go,2048,europe-west1,141,82,59,Google 2048 MB
google,go,2048,europe-west1,221,75,146,Google 2048 MB
google,go,2048,europe-west1,157,89,68,Google 2048 MB
google,go,2048,europe-west1,148,86,62,Google 2048 MB
google,go,2048,europe-west1,153,80,73,Google 2048 MB
google,go,2048,europe-west1,145,75,70,Google 2048 MB
google,go,2048,europe-west1,162,97,65,Google 2048 MB
google,go,2048,europe-west1,223,79,144,Google 2048 MB
google,go,2048,europe-west1,189,113,76,Google 2048 MB
google,go,2048,europe-west1,139,77,62,Google 2048 MB
google,go,2048,europe-west1,150,83,67,Google 2048 MB
google,go,2048,europe-west1,286,131,155,Google 2048 MB
google,go,2048,europe-west1,183,111,72,Google 2048 MB
google,go,2048,europe-west1,222,78,144,Google 2048 MB
google,go,2048,europe-west1,222,84,138,Google 2048 MB
google,go,2048,europe-west1,215,79,136,Google 2048 MB
google,go,2048,europe-west1,213,79,134,Google 2048 MB
google,go,2048,europe-west1,211,152,59,Google 2048 MB
google,go,2048,europe-west1,148,79,69,Google 2048 MB
google,go,2048,europe-west1,210,80,130,Google 2048 MB
google,go,2048,europe-west1,366,237,129,Google 2048 MB
google,go,2048,europe-west1,171,108,63,Google 2048 MB
google,go,2048,europe-west1,211,89,122,Google 2048 MB
google,go,2048,europe-west1,208,81,127,Google 2048 MB
google,go,2048,europe-west1,145,78,67,Google 2048 MB
google,go,2048,europe-west1,214,103,111,Google 2048 MB
google,go,2048,europe-west1,164,81,83,Google 2048 MB
google,go,2048,europe-west1,138,79,59,Google 2048 MB
google,go,2048,europe-west1,186,129,57,Google 2048 MB
google,go,2048,europe-west1,194,83,111,Google 2048 MB
google,go,2048,europe-west1,188,127,61,Google 2048 MB
google,go,2048,europe-west1,181,85,96,Google 2048 MB
google,go,2048,europe-west1,177,115,62,Google 2048 MB
google,go,2048,europe-west1,370,254,116,Google 2048 MB
google,go,2048,europe-west1,193,97,96,Google 2048 MB
google,go,2048,europe-west1,171,110,61,Google 2048 MB
google,go,2048,europe-west1,163,76,87,Google 2048 MB
google,go,2048,europe-west1,163,80,83,Google 2048 MB
google,go,2048,europe-west1,191,101,90,Google 2048 MB
google,go,2048,europe-west1,172,108,64,Google 2048 MB
google,go,2048,europe-west1,201,134,67,Google 2048 MB
google,go,2048,europe-west1,226,165,61,Google 2048 MB
google,go,2048,europe-west1,582,405,177,Google 2048 MB
google,go,2048,europe-west1,1188,79,1109,Google 2048 MB
google,go,2048,europe-west1,181,121,60,Google 2048 MB
google,go,2048,europe-west1,200,112,88,Google 2048 MB
google,go,2048,europe-west1,142,77,65,Google 2048 MB
google,go,2048,europe-west1,209,112,97,Google 2048 MB
google,go,2048,europe-west1,182,119,63,Google 2048 MB
google,go,2048,europe-west1,294,176,118,Google 2048 MB
google,go,2048,europe-west1,186,125,61,Google 2048 MB
google,go,2048,europe-west1,305,142,163,Google 2048 MB
google,go,2048,europe-west1,156,90,66,Google 2048 MB
google,go,2048,europe-west1,162,100,62,Google 2048 MB
google,go,2048,europe-west1,664,109,555,Google 2048 MB
google,go,2048,europe-west1,217,129,88,Google 2048 MB
google,go,2048,europe-west1,300,221,79,Google 2048 MB
google,go,2048,europe-west1,171,101,70,Google 2048 MB
google,go,2048,europe-west1,159,100,59,Google 2048 MB
google,go,2048,europe-west1,206,148,58,Google 2048 MB
google,go,2048,europe-west1,216,88,128,Google 2048 MB
google,go,2048,europe-west1,152,80,72,Google 2048 MB
google,go,2048,europe-west1,214,141,73,Google 2048 MB
google,go,2048,europe-west1,259,134,125,Google 2048 MB
google,go,2048,europe-west1,227,93,134,Google 2048 MB
google,go,2048,europe-west1,128,75,53,Google 2048 MB
google,go,2048,europe-west1,286,218,68,Google 2048 MB
google,go,2048,europe-west1,217,96,121,Google 2048 MB
google,go,2048,europe-west1,146,92,54,Google 2048 MB
google,go,2048,europe-west1,190,99,91,Google 2048 MB
google,go,2048,europe-west1,164,96,68,Google 2048 MB
google,go,2048,europe-west1,309,227,82,Google 2048 MB
google,go,2048,europe-west1,156,91,65,Google 2048 MB
google,go,2048,europe-west1,203,116,87,Google 2048 MB
google,go,2048,europe-west1,310,167,143,Google 2048 MB
google,go,2048,europe-west1,167,100,67,Google 2048 MB
google,go,2048,europe-west1,172,107,65,Google 2048 MB
google,go,2048,europe-west1,464,362,102,Google 2048 MB
google,go,2048,europe-west1,223,147,76,Google 2048 MB
google,go,2048,europe-west1,336,244,92,Google 2048 MB
google,go,2048,europe-west1,293,150,143,Google 2048 MB
google,go,2048,europe-west1,183,103,80,Google 2048 MB
google,go,2048,europe-west1,187,118,69,Google 2048 MB
google,go,2048,europe-west1,159,95,64,Google 2048 MB
google,go,2048,europe-west1,269,124,145,Google 2048 MB
google,go,2048,europe-west1,176,110,66,Google 2048 MB
google,go,2048,europe-west1,197,129,68,Google 2048 MB
google,go,2048,europe-west1,190,117,73,Google 2048 MB
google,go,2048,europe-west1,413,102,311,Google 2048 MB
google,go,2048,europe-west1,192,119,73,Google 2048 MB
google,go,2048,europe-west1,185,120,65,Google 2048 MB
google,go,2048,europe-west1,302,226,76,Google 2048 MB
google,go,2048,europe-west1,208,137,71,Google 2048 MB
ibm,go,128,eu-de,340,96,244,IBM 0128 MB
ibm,go,128,eu-de,263,93,170,IBM 0128 MB
ibm,go,128,eu-de,283,95,188,IBM 0128 MB
ibm,go,128,eu-de,326,93,233,IBM 0128 MB
ibm,go,128,eu-de,271,93,178,IBM 0128 MB
ibm,go,128,eu-de,265,92,173,IBM 0128 MB
ibm,go,128,eu-de,255,93,162,IBM 0128 MB
ibm,go,128,eu-de,297,93,204,IBM 0128 MB
ibm,go,128,eu-de,274,94,180,IBM 0128 MB
ibm,go,128,eu-de,293,93,200,IBM 0128 MB
ibm,go,128,eu-de,277,114,163,IBM 0128 MB
ibm,go,128,eu-de,276,109,167,IBM 0128 MB
ibm,go,128,eu-de,203,94,109,IBM 0128 MB
ibm,go,128,eu-de,266,96,170,IBM 0128 MB
ibm,go,128,eu-de,267,95,172,IBM 0128 MB
ibm,go,128,eu-de,249,95,154,IBM 0128 MB
ibm,go,128,eu-de,271,98,173,IBM 0128 MB
ibm,go,128,eu-de,273,95,178,IBM 0128 MB
ibm,go,128,eu-de,276,97,179,IBM 0128 MB
ibm,go,128,eu-de,341,98,243,IBM 0128 MB
ibm,go,128,eu-de,201,95,106,IBM 0128 MB
ibm,go,128,eu-de,270,97,173,IBM 0128 MB
ibm,go,128,eu-de,266,93,173,IBM 0128 MB
ibm,go,128,eu-de,278,94,184,IBM 0128 MB
ibm,go,128,eu-de,250,95,155,IBM 0128 MB
ibm,go,128,eu-de,266,99,167,IBM 0128 MB
ibm,go,128,eu-de,272,96,176,IBM 0128 MB
ibm,go,128,eu-de,258,94,164,IBM 0128 MB
ibm,go,128,eu-de,209,93,116,IBM 0128 MB
ibm,go,128,eu-de,277,103,174,IBM 0128 MB
ibm,go,128,eu-de,267,97,170,IBM 0128 MB
ibm,go,128,eu-de,274,93,181,IBM 0128 MB
ibm,go,128,eu-de,285,95,190,IBM 0128 MB
ibm,go,128,eu-de,263,96,167,IBM 0128 MB
ibm,go,128,eu-de,281,94,187,IBM 0128 MB
ibm,go,128,eu-de,496,94,402,IBM 0128 MB
ibm,go,128,eu-de,261,96,165,IBM 0128 MB
ibm,go,128,eu-de,268,94,174,IBM 0128 MB
ibm,go,128,eu-de,271,106,165,IBM 0128 MB
ibm,go,128,eu-de,217,94,123,IBM 0128 MB
ibm,go,128,eu-de,259,98,161,IBM 0128 MB
ibm,go,128,eu-de,220,94,126,IBM 0128 MB
ibm,go,128,eu-de,247,95,152,IBM 0128 MB
ibm,go,128,eu-de,263,93,170,IBM 0128 MB
ibm,go,128,eu-de,284,97,187,IBM 0128 MB
ibm,go,128,eu-de,266,96,170,IBM 0128 MB
ibm,go,128,eu-de,263,94,169,IBM 0128 MB
ibm,go,128,eu-de,256,100,156,IBM 0128 MB
ibm,go,128,eu-de,273,95,178,IBM 0128 MB
ibm,go,128,eu-de,261,96,165,IBM 0128 MB
ibm,go,128,eu-de,253,98,155,IBM 0128 MB
ibm,go,128,eu-de,365,95,270,IBM 0128 MB
ibm,go,128,eu-de,284,95,189,IBM 0128 MB
ibm,go,128,eu-de,256,97,159,IBM 0128 MB
ibm,go,128,eu-de,284,95,189,IBM 0128 MB
ibm,go,128,eu-de,224,94,130,IBM 0128 MB
ibm,go,128,eu-de,265,94,171,IBM 0128 MB
ibm,go,128,eu-de,271,94,177,IBM 0128 MB
ibm,go,128,eu-de,260,98,162,IBM 0128 MB
ibm,go,128,eu-de,257,95,162,IBM 0128 MB
ibm,go,128,eu-de,289,98,191,IBM 0128 MB
ibm,go,128,eu-de,257,94,163,IBM 0128 MB
ibm,go,128,eu-de,277,95,182,IBM 0128 MB
ibm,go,128,eu-de,252,97,155,IBM 0128 MB
ibm,go,128,eu-de,257,98,159,IBM 0128 MB
ibm,go,128,eu-de,318,97,221,IBM 0128 MB
ibm,go,128,eu-de,267,94,173,IBM 0128 MB
ibm,go,128,eu-de,279,95,184,IBM 0128 MB
ibm,go,128,eu-de,258,94,164,IBM 0128 MB
ibm,go,128,eu-de,273,94,179,IBM 0128 MB
ibm,go,128,eu-de,277,94,183,IBM 0128 MB
ibm,go,128,eu-de,260,97,163,IBM 0128 MB
ibm,go,128,eu-de,256,96,160,IBM 0128 MB
ibm,go,128,eu-de,252,95,157,IBM 0128 MB
ibm,go,128,eu-de,295,96,199,IBM 0128 MB
ibm,go,128,eu-de,269,95,174,IBM 0128 MB
ibm,go,128,eu-de,258,95,163,IBM 0128 MB
ibm,go,128,eu-de,253,95,158,IBM 0128 MB
ibm,go,128,eu-de,309,94,215,IBM 0128 MB
ibm,go,128,eu-de,265,94,171,IBM 0128 MB
ibm,go,128,eu-de,681,94,587,IBM 0128 MB
ibm,go,128,eu-de,337,97,240,IBM 0128 MB
ibm,go,128,eu-de,257,94,163,IBM 0128 MB
ibm,go,128,eu-de,272,95,177,IBM 0128 MB
ibm,go,128,eu-de,290,95,195,IBM 0128 MB
ibm,go,128,eu-de,293,94,199,IBM 0128 MB
ibm,go,128,eu-de,258,94,164,IBM 0128 MB
ibm,go,128,eu-de,266,94,172,IBM 0128 MB
ibm,go,128,eu-de,262,94,168,IBM 0128 MB
ibm,go,128,eu-de,5752,95,5657,IBM 0128 MB
ibm,go,128,eu-de,16313,94,16219,IBM 0128 MB
ibm,go,128,eu-de,10846,102,10744,IBM 0128 MB
ibm,go,128,eu-de,21359,88,21271,IBM 0128 MB
ibm,go,128,eu-de,1187,60,1127,IBM 0128 MB
ibm,go,128,eu-de,213,61,152,IBM 0128 MB
ibm,go,128,eu-de,211,59,152,IBM 0128 MB
ibm,go,128,eu-de,252,58,194,IBM 0128 MB
ibm,go,128,eu-de,237,60,177,IBM 0128 MB
ibm,go,128,eu-de,229,59,170,IBM 0128 MB
ibm,go,128,eu-de,233,57,176,IBM 0128 MB
ibm,go,256,eu-de,282,59,223,IBM 0256 MB
ibm,go,256,eu-de,321,58,263,IBM 0256 MB
ibm,go,256,eu-de,170,57,113,IBM 0256 MB
ibm,go,256,eu-de,245,58,187,IBM 0256 MB
ibm,go,256,eu-de,209,57,152,IBM 0256 MB
ibm,go,256,eu-de,214,57,157,IBM 0256 MB
ibm,go,256,eu-de,261,59,202,IBM 0256 MB
ibm,go,256,eu-de,241,60,181,IBM 0256 MB
ibm,go,256,eu-de,229,58,171,IBM 0256 MB
ibm,go,256,eu-de,155,59,96,IBM 0256 MB
ibm,go,256,eu-de,204,59,145,IBM 0256 MB
ibm,go,256,eu-de,225,60,165,IBM 0256 MB
ibm,go,256,eu-de,281,57,224,IBM 0256 MB
ibm,go,256,eu-de,228,58,170,IBM 0256 MB
ibm,go,256,eu-de,199,60,139,IBM 0256 MB
ibm,go,256,eu-de,222,59,163,IBM 0256 MB
ibm,go,256,eu-de,546,61,485,IBM 0256 MB
ibm,go,256,eu-de,565,58,507,IBM 0256 MB
ibm,go,256,eu-de,166,59,107,IBM 0256 MB
ibm,go,256,eu-de,216,57,159,IBM 0256 MB
ibm,go,256,eu-de,216,60,156,IBM 0256 MB
ibm,go,256,eu-de,237,60,177,IBM 0256 MB
ibm,go,256,eu-de,219,60,159,IBM 0256 MB
ibm,go,256,eu-de,210,59,151,IBM 0256 MB
ibm,go,256,eu-de,208,60,148,IBM 0256 MB
ibm,go,256,eu-de,238,56,182,IBM 0256 MB
ibm,go,256,eu-de,254,59,195,IBM 0256 MB
ibm,go,256,eu-de,214,59,155,IBM 0256 MB
ibm,go,256,eu-de,227,59,168,IBM 0256 MB
ibm,go,256,eu-de,150,60,90,IBM 0256 MB
ibm,go,256,eu-de,219,59,160,IBM 0256 MB
ibm,go,256,eu-de,224,61,163,IBM 0256 MB
ibm,go,256,eu-de,207,59,148,IBM 0256 MB
ibm,go,256,eu-de,214,58,156,IBM 0256 MB
ibm,go,256,eu-de,203,58,145,IBM 0256 MB
ibm,go,256,eu-de,224,59,165,IBM 0256 MB
ibm,go,256,eu-de,202,60,142,IBM 0256 MB
ibm,go,256,eu-de,251,58,193,IBM 0256 MB
ibm,go,256,eu-de,195,65,130,IBM 0256 MB
ibm,go,256,eu-de,219,60,159,IBM 0256 MB
ibm,go,256,eu-de,239,57,182,IBM 0256 MB
ibm,go,256,eu-de,236,62,174,IBM 0256 MB
ibm,go,256,eu-de,218,59,159,IBM 0256 MB
ibm,go,256,eu-de,217,61,156,IBM 0256 MB
ibm,go,256,eu-de,231,74,157,IBM 0256 MB
ibm,go,256,eu-de,232,61,171,IBM 0256 MB
ibm,go,256,eu-de,212,56,156,IBM 0256 MB
ibm,go,256,eu-de,218,59,159,IBM 0256 MB
ibm,go,256,eu-de,207,58,149,IBM 0256 MB
ibm,go,256,eu-de,240,61,179,IBM 0256 MB
ibm,go,256,eu-de,197,57,140,IBM 0256 MB
ibm,go,256,eu-de,196,60,136,IBM 0256 MB
ibm,go,256,eu-de,239,61,178,IBM 0256 MB
ibm,go,256,eu-de,202,63,139,IBM 0256 MB
ibm,go,256,eu-de,228,58,170,IBM 0256 MB
ibm,go,256,eu-de,207,57,150,IBM 0256 MB
ibm,go,256,eu-de,270,61,209,IBM 0256 MB
ibm,go,256,eu-de,190,61,129,IBM 0256 MB
ibm,go,256,eu-de,211,60,151,IBM 0256 MB
ibm,go,256,eu-de,237,59,178,IBM 0256 MB
ibm,go,256,eu-de,226,58,168,IBM 0256 MB
ibm,go,256,eu-de,212,59,153,IBM 0256 MB
ibm,go,256,eu-de,266,61,205,IBM 0256 MB
ibm,go,256,eu-de,222,62,160,IBM 0256 MB
ibm,go,256,eu-de,211,60,151,IBM 0256 MB
ibm,go,256,eu-de,217,62,155,IBM 0256 MB
ibm,go,256,eu-de,180,61,119,IBM 0256 MB
ibm,go,256,eu-de,324,58,266,IBM 0256 MB
ibm,go,256,eu-de,226,59,167,IBM 0256 MB
ibm,go,256,eu-de,223,61,162,IBM 0256 MB
ibm,go,256,eu-de,236,64,172,IBM 0256 MB
ibm,go,256,eu-de,215,59,156,IBM 0256 MB
ibm,go,256,eu-de,279,72,207,IBM 0256 MB
ibm,go,256,eu-de,216,60,156,IBM 0256 MB
ibm,go,256,eu-de,230,60,170,IBM 0256 MB
ibm,go,256,eu-de,254,60,194,IBM 0256 MB
ibm,go,256,eu-de,255,60,195,IBM 0256 MB
ibm,go,256,eu-de,162,59,103,IBM 0256 MB
ibm,go,256,eu-de,205,62,143,IBM 0256 MB
ibm,go,256,eu-de,160,61,99,IBM 0256 MB
ibm,go,256,eu-de,227,59,168,IBM 0256 MB
ibm,go,256,eu-de,222,62,160,IBM 0256 MB
ibm,go,256,eu-de,688,58,630,IBM 0256 MB
ibm,go,256,eu-de,224,60,164,IBM 0256 MB
ibm,go,256,eu-de,227,59,168,IBM 0256 MB
ibm,go,256,eu-de,203,59,144,IBM 0256 MB
ibm,go,256,eu-de,203,56,147,IBM 0256 MB
ibm,go,256,eu-de,205,58,147,IBM 0256 MB
ibm,go,256,eu-de,202,58,144,IBM 0256 MB
ibm,go,256,eu-de,215,58,157,IBM 0256 MB
ibm,go,256,eu-de,216,62,154,IBM 0256 MB
ibm,go,256,eu-de,237,59,178,IBM 0256 MB
ibm,go,256,eu-de,216,61,155,IBM 0256 MB
ibm,go,256,eu-de,205,59,146,IBM 0256 MB
ibm,go,256,eu-de,152,57,95,IBM 0256 MB
ibm,go,256,eu-de,237,57,180,IBM 0256 MB
ibm,go,256,eu-de,161,62,99,IBM 0256 MB
ibm,go,256,eu-de,216,59,157,IBM 0256 MB
ibm,go,256,eu-de,327,60,267,IBM 0256 MB
ibm,go,256,eu-de,212,58,154,IBM 0256 MB
ibm,go,512,eu-de,227,58,169,IBM 0512 MB
ibm,go,512,eu-de,224,59,165,IBM 0512 MB
ibm,go,512,eu-de,238,59,179,IBM 0512 MB
ibm,go,512,eu-de,244,57,187,IBM 0512 MB
ibm,go,512,eu-de,203,58,145,IBM 0512 MB
ibm,go,512,eu-de,259,58,201,IBM 0512 MB
ibm,go,512,eu-de,667,56,611,IBM 0512 MB
ibm,go,512,eu-de,208,58,150,IBM 0512 MB
ibm,go,512,eu-de,206,61,145,IBM 0512 MB
ibm,go,512,eu-de,215,57,158,IBM 0512 MB
ibm,go,512,eu-de,211,59,152,IBM 0512 MB
ibm,go,512,eu-de,205,60,145,IBM 0512 MB
ibm,go,512,eu-de,219,58,161,IBM 0512 MB
ibm,go,512,eu-de,244,60,184,IBM 0512 MB
ibm,go,512,eu-de,211,59,152,IBM 0512 MB
ibm,go,512,eu-de,201,59,142,IBM 0512 MB
ibm,go,512,eu-de,249,57,192,IBM 0512 MB
ibm,go,512,eu-de,252,60,192,IBM 0512 MB
ibm,go,512,eu-de,337,60,277,IBM 0512 MB
ibm,go,512,eu-de,222,61,161,IBM 0512 MB
ibm,go,512,eu-de,221,60,161,IBM 0512 MB
ibm,go,512,eu-de,160,67,93,IBM 0512 MB
ibm,go,512,eu-de,206,60,146,IBM 0512 MB
ibm,go,512,eu-de,173,59,114,IBM 0512 MB
ibm,go,512,eu-de,232,61,171,IBM 0512 MB
ibm,go,512,eu-de,180,67,113,IBM 0512 MB
ibm,go,512,eu-de,273,60,213,IBM 0512 MB
ibm,go,512,eu-de,242,59,183,IBM 0512 MB
ibm,go,512,eu-de,219,61,158,IBM 0512 MB
ibm,go,512,eu-de,253,62,191,IBM 0512 MB
ibm,go,512,eu-de,248,60,188,IBM 0512 MB
ibm,go,512,eu-de,198,58,140,IBM 0512 MB
ibm,go,512,eu-de,267,58,209,IBM 0512 MB
ibm,go,512,eu-de,221,64,157,IBM 0512 MB
ibm,go,512,eu-de,205,61,144,IBM 0512 MB
ibm,go,512,eu-de,206,59,147,IBM 0512 MB
ibm,go,512,eu-de,211,59,152,IBM 0512 MB
ibm,go,512,eu-de,174,59,115,IBM 0512 MB
ibm,go,512,eu-de,207,61,146,IBM 0512 MB
ibm,go,512,eu-de,218,62,156,IBM 0512 MB
ibm,go,512,eu-de,249,62,187,IBM 0512 MB
ibm,go,512,eu-de,156,60,96,IBM 0512 MB
ibm,go,512,eu-de,212,61,151,IBM 0512 MB
ibm,go,512,eu-de,175,60,115,IBM 0512 MB
ibm,go,512,eu-de,193,60,133,IBM 0512 MB
ibm,go,512,eu-de,212,58,154,IBM 0512 MB
ibm,go,512,eu-de,227,68,159,IBM 0512 MB
ibm,go,512,eu-de,156,63,93,IBM 0512 MB
ibm,go,512,eu-de,208,59,149,IBM 0512 MB
ibm,go,512,eu-de,204,60,144,IBM 0512 MB
ibm,go,512,eu-de,288,62,226,IBM 0512 MB
ibm,go,512,eu-de,248,60,188,IBM 0512 MB
ibm,go,512,eu-de,373,58,315,IBM 0512 MB
ibm,go,512,eu-de,223,63,160,IBM 0512 MB
ibm,go,512,eu-de,290,67,223,IBM 0512 MB
ibm,go,512,eu-de,195,59,136,IBM 0512 MB
ibm,go,512,eu-de,442,60,382,IBM 0512 MB
ibm,go,512,eu-de,234,65,169,IBM 0512 MB
ibm,go,512,eu-de,207,61,146,IBM 0512 MB
ibm,go,512,eu-de,230,61,169,IBM 0512 MB
ibm,go,512,eu-de,226,60,166,IBM 0512 MB
ibm,go,512,eu-de,206,61,145,IBM 0512 MB
ibm,go,512,eu-de,216,62,154,IBM 0512 MB
ibm,go,512,eu-de,259,61,198,IBM 0512 MB
ibm,go,512,eu-de,202,61,141,IBM 0512 MB
ibm,go,512,eu-de,204,59,145,IBM 0512 MB
ibm,go,512,eu-de,715,59,656,IBM 0512 MB
ibm,go,512,eu-de,159,63,96,IBM 0512 MB
ibm,go,512,eu-de,220,60,160,IBM 0512 MB
ibm,go,512,eu-de,220,58,162,IBM 0512 MB
ibm,go,512,eu-de,164,62,102,IBM 0512 MB
ibm,go,512,eu-de,237,59,178,IBM 0512 MB
ibm,go,512,eu-de,419,60,359,IBM 0512 MB
ibm,go,512,eu-de,226,61,165,IBM 0512 MB
ibm,go,512,eu-de,213,60,153,IBM 0512 MB
ibm,go,512,eu-de,202,59,143,IBM 0512 MB
ibm,go,512,eu-de,161,60,101,IBM 0512 MB
ibm,go,512,eu-de,212,60,152,IBM 0512 MB
ibm,go,512,eu-de,634,62,572,IBM 0512 MB
ibm,go,512,eu-de,178,59,119,IBM 0512 MB
ibm,go,512,eu-de,490,59,431,IBM 0512 MB
ibm,go,512,eu-de,214,59,155,IBM 0512 MB
ibm,go,512,eu-de,258,67,191,IBM 0512 MB
ibm,go,512,eu-de,237,59,178,IBM 0512 MB
ibm,go,512,eu-de,154,60,94,IBM 0512 MB
ibm,go,512,eu-de,250,60,190,IBM 0512 MB
ibm,go,512,eu-de,203,63,140,IBM 0512 MB
ibm,go,512,eu-de,244,62,182,IBM 0512 MB
ibm,go,512,eu-de,247,60,187,IBM 0512 MB
ibm,go,512,eu-de,249,60,189,IBM 0512 MB
ibm,go,512,eu-de,709,61,648,IBM 0512 MB
ibm,go,512,eu-de,217,64,153,IBM 0512 MB
ibm,go,512,eu-de,673,62,611,IBM 0512 MB
ibm,go,512,eu-de,216,60,156,IBM 0512 MB
ibm,go,512,eu-de,258,62,196,IBM 0512 MB
ibm,go,512,eu-de,162,60,102,IBM 0512 MB
ibm,go,512,eu-de,213,61,152,IBM 0512 MB
ibm,go,512,eu-de,223,59,164,IBM 0512 MB
ibm,go,512,eu-de,174,58,116,IBM 0512 MB
ibm,go,512,eu-de,201,60,141,IBM 0512 MB
ibm,go,1024,eu-de,511,60,451,IBM 1024 MB
ibm,go,1024,eu-de,236,62,174,IBM 1024 MB
ibm,go,1024,eu-de,247,60,187,IBM 1024 MB
ibm,go,1024,eu-de,223,58,165,IBM 1024 MB
ibm,go,1024,eu-de,200,57,143,IBM 1024 MB
ibm,go,1024,eu-de,218,61,157,IBM 1024 MB
ibm,go,1024,eu-de,207,56,151,IBM 1024 MB
ibm,go,1024,eu-de,218,59,159,IBM 1024 MB
ibm,go,1024,eu-de,202,58,144,IBM 1024 MB
ibm,go,1024,eu-de,206,60,146,IBM 1024 MB
ibm,go,1024,eu-de,186,57,129,IBM 1024 MB
ibm,go,1024,eu-de,241,59,182,IBM 1024 MB
ibm,go,1024,eu-de,204,59,145,IBM 1024 MB
ibm,go,1024,eu-de,253,57,196,IBM 1024 MB
ibm,go,1024,eu-de,270,60,210,IBM 1024 MB
ibm,go,1024,eu-de,190,59,131,IBM 1024 MB
ibm,go,1024,eu-de,206,60,146,IBM 1024 MB
ibm,go,1024,eu-de,314,61,253,IBM 1024 MB
ibm,go,1024,eu-de,263,59,204,IBM 1024 MB
ibm,go,1024,eu-de,212,57,155,IBM 1024 MB
ibm,go,1024,eu-de,242,59,183,IBM 1024 MB
ibm,go,1024,eu-de,199,57,142,IBM 1024 MB
ibm,go,1024,eu-de,206,57,149,IBM 1024 MB
ibm,go,1024,eu-de,241,62,179,IBM 1024 MB
ibm,go,1024,eu-de,199,58,141,IBM 1024 MB
ibm,go,1024,eu-de,251,61,190,IBM 1024 MB
ibm,go,1024,eu-de,208,58,150,IBM 1024 MB
ibm,go,1024,eu-de,213,58,155,IBM 1024 MB
ibm,go,1024,eu-de,235,60,175,IBM 1024 MB
ibm,go,1024,eu-de,207,58,149,IBM 1024 MB
ibm,go,1024,eu-de,221,59,162,IBM 1024 MB
ibm,go,1024,eu-de,159,60,99,IBM 1024 MB
ibm,go,1024,eu-de,209,62,147,IBM 1024 MB
ibm,go,1024,eu-de,253,60,193,IBM 1024 MB
ibm,go,1024,eu-de,210,61,149,IBM 1024 MB
ibm,go,1024,eu-de,217,57,160,IBM 1024 MB
ibm,go,1024,eu-de,224,60,164,IBM 1024 MB
ibm,go,1024,eu-de,218,60,158,IBM 1024 MB
ibm,go,1024,eu-de,228,59,169,IBM 1024 MB
ibm,go,1024,eu-de,216,61,155,IBM 1024 MB
ibm,go,1024,eu-de,219,72,147,IBM 1024 MB
ibm,go,1024,eu-de,148,57,91,IBM 1024 MB
ibm,go,1024,eu-de,207,60,147,IBM 1024 MB
ibm,go,1024,eu-de,197,61,136,IBM 1024 MB
ibm,go,1024,eu-de,289,59,230,IBM 1024 MB
ibm,go,1024,eu-de,247,58,189,IBM 1024 MB
ibm,go,1024,eu-de,166,60,106,IBM 1024 MB
ibm,go,1024,eu-de,239,58,181,IBM 1024 MB
ibm,go,1024,eu-de,213,64,149,IBM 1024 MB
ibm,go,1024,eu-de,211,60,151,IBM 1024 MB
ibm,go,1024,eu-de,953,61,892,IBM 1024 MB
ibm,go,1024,eu-de,145,57,88,IBM 1024 MB
ibm,go,1024,eu-de,215,59,156,IBM 1024 MB
ibm,go,1024,eu-de,234,60,174,IBM 1024 MB
ibm,go,1024,eu-de,212,60,152,IBM 1024 MB
ibm,go,1024,eu-de,214,66,148,IBM 1024 MB
ibm,go,1024,eu-de,218,58,160,IBM 1024 MB
ibm,go,1024,eu-de,234,61,173,IBM 1024 MB
ibm,go,1024,eu-de,209,59,150,IBM 1024 MB
ibm,go,1024,eu-de,237,58,179,IBM 1024 MB
ibm,go,1024,eu-de,226,67,159,IBM 1024 MB
ibm,go,1024,eu-de,227,62,165,IBM 1024 MB
ibm,go,1024,eu-de,208,61,147,IBM 1024 MB
ibm,go,1024,eu-de,217,60,157,IBM 1024 MB
ibm,go,1024,eu-de,216,60,156,IBM 1024 MB
ibm,go,1024,eu-de,218,60,158,IBM 1024 MB
ibm,go,1024,eu-de,205,63,142,IBM 1024 MB
ibm,go,1024,eu-de,232,60,172,IBM 1024 MB
ibm,go,1024,eu-de,208,60,148,IBM 1024 MB
ibm,go,1024,eu-de,208,60,148,IBM 1024 MB
ibm,go,1024,eu-de,223,59,164,IBM 1024 MB
ibm,go,1024,eu-de,235,60,175,IBM 1024 MB
ibm,go,1024,eu-de,680,59,621,IBM 1024 MB
ibm,go,1024,eu-de,197,60,137,IBM 1024 MB
ibm,go,1024,eu-de,250,59,191,IBM 1024 MB
ibm,go,1024,eu-de,229,59,170,IBM 1024 MB
ibm,go,1024,eu-de,213,58,155,IBM 1024 MB
ibm,go,1024,eu-de,173,61,112,IBM 1024 MB
ibm,go,1024,eu-de,215,60,155,IBM 1024 MB
ibm,go,1024,eu-de,195,60,135,IBM 1024 MB
ibm,go,1024,eu-de,290,59,231,IBM 1024 MB
ibm,go,1024,eu-de,229,59,170,IBM 1024 MB
ibm,go,1024,eu-de,205,59,146,IBM 1024 MB
ibm,go,1024,eu-de,312,61,251,IBM 1024 MB
ibm,go,1024,eu-de,159,57,102,IBM 1024 MB
ibm,go,1024,eu-de,228,59,169,IBM 1024 MB
ibm,go,1024,eu-de,735,58,677,IBM 1024 MB
ibm,go,1024,eu-de,214,61,153,IBM 1024 MB
ibm,go,1024,eu-de,287,61,226,IBM 1024 MB
ibm,go,1024,eu-de,169,59,110,IBM 1024 MB
ibm,go,1024,eu-de,241,61,180,IBM 1024 MB
ibm,go,1024,eu-de,186,61,125,IBM 1024 MB
ibm,go,1024,eu-de,249,60,189,IBM 1024 MB
ibm,go,1024,eu-de,154,60,94,IBM 1024 MB
ibm,go,1024,eu-de,224,59,165,IBM 1024 MB
ibm,go,1024,eu-de,226,61,165,IBM 1024 MB
ibm,go,1024,eu-de,234,60,174,IBM 1024 MB
ibm,go,1024,eu-de,403,60,343,IBM 1024 MB
ibm,go,1024,eu-de,216,60,156,IBM 1024 MB
ibm,go,1024,eu-de,218,61,157,IBM 1024 MB
ibm,go,2048,eu-de,223,57,166,IBM 2048 MB
ibm,go,2048,eu-de,207,58,149,IBM 2048 MB
ibm,go,2048,eu-de,232,58,174,IBM 2048 MB
ibm,go,2048,eu-de,203,59,144,IBM 2048 MB
ibm,go,2048,eu-de,218,59,159,IBM 2048 MB
ibm,go,2048,eu-de,146,58,88,IBM 2048 MB
ibm,go,2048,eu-de,212,61,151,IBM 2048 MB
ibm,go,2048,eu-de,243,60,183,IBM 2048 MB
ibm,go,2048,eu-de,235,58,177,IBM 2048 MB
ibm,go,2048,eu-de,680,61,619,IBM 2048 MB
ibm,go,2048,eu-de,222,59,163,IBM 2048 MB
ibm,go,2048,eu-de,206,59,147,IBM 2048 MB
ibm,go,2048,eu-de,205,57,148,IBM 2048 MB
ibm,go,2048,eu-de,251,59,192,IBM 2048 MB
ibm,go,2048,eu-de,222,62,160,IBM 2048 MB
ibm,go,2048,eu-de,153,59,94,IBM 2048 MB
ibm,go,2048,eu-de,219,61,158,IBM 2048 MB
ibm,go,2048,eu-de,160,58,102,IBM 2048 MB
ibm,go,2048,eu-de,244,61,183,IBM 2048 MB
ibm,go,2048,eu-de,302,59,243,IBM 2048 MB
ibm,go,2048,eu-de,234,59,175,IBM 2048 MB
ibm,go,2048,eu-de,169,61,108,IBM 2048 MB
ibm,go,2048,eu-de,208,62,146,IBM 2048 MB
ibm,go,2048,eu-de,226,59,167,IBM 2048 MB
ibm,go,2048,eu-de,229,59,170,IBM 2048 MB
ibm,go,2048,eu-de,229,61,168,IBM 2048 MB
ibm,go,2048,eu-de,255,67,188,IBM 2048 MB
ibm,go,2048,eu-de,162,62,100,IBM 2048 MB
ibm,go,2048,eu-de,365,59,306,IBM 2048 MB
ibm,go,2048,eu-de,233,60,173,IBM 2048 MB
ibm,go,2048,eu-de,153,59,94,IBM 2048 MB
ibm,go,2048,eu-de,222,61,161,IBM 2048 MB
ibm,go,2048,eu-de,258,61,197,IBM 2048 MB
ibm,go,2048,eu-de,235,63,172,IBM 2048 MB
ibm,go,2048,eu-de,210,59,151,IBM 2048 MB
ibm,go,2048,eu-de,200,60,140,IBM 2048 MB
ibm,go,2048,eu-de,264,60,204,IBM 2048 MB
ibm,go,2048,eu-de,205,66,139,IBM 2048 MB
ibm,go,2048,eu-de,222,62,160,IBM 2048 MB
ibm,go,2048,eu-de,215,60,155,IBM 2048 MB
ibm,go,2048,eu-de,158,60,98,IBM 2048 MB
ibm,go,2048,eu-de,206,61,145,IBM 2048 MB
ibm,go,2048,eu-de,226,59,167,IBM 2048 MB
ibm,go,2048,eu-de,283,64,219,IBM 2048 MB
ibm,go,2048,eu-de,163,58,105,IBM 2048 MB
ibm,go,2048,eu-de,224,58,166,IBM 2048 MB
ibm,go,2048,eu-de,213,67,146,IBM 2048 MB
ibm,go,2048,eu-de,216,61,155,IBM 2048 MB
ibm,go,2048,eu-de,231,61,170,IBM 2048 MB
ibm,go,2048,eu-de,254,60,194,IBM 2048 MB
ibm,go,2048,eu-de,201,65,136,IBM 2048 MB
ibm,go,2048,eu-de,210,64,146,IBM 2048 MB
ibm,go,2048,eu-de,152,59,93,IBM 2048 MB
ibm,go,2048,eu-de,225,61,164,IBM 2048 MB
ibm,go,2048,eu-de,238,61,177,IBM 2048 MB
ibm,go,2048,eu-de,196,61,135,IBM 2048 MB
ibm,go,2048,eu-de,222,58,164,IBM 2048 MB
ibm,go,2048,eu-de,158,60,98,IBM 2048 MB
ibm,go,2048,eu-de,223,61,162,IBM 2048 MB
ibm,go,2048,eu-de,201,61,140,IBM 2048 MB
ibm,go,2048,eu-de,216,60,156,IBM 2048 MB
ibm,go,2048,eu-de,741,59,682,IBM 2048 MB
ibm,go,2048,eu-de,206,59,147,IBM 2048 MB
ibm,go,2048,eu-de,259,60,199,IBM 2048 MB
ibm,go,2048,eu-de,195,61,134,IBM 2048 MB
ibm,go,2048,eu-de,158,60,98,IBM 2048 MB
ibm,go,2048,eu-de,213,61,152,IBM 2048 MB
ibm,go,2048,eu-de,241,60,181,IBM 2048 MB
ibm,go,2048,eu-de,163,61,102,IBM 2048 MB
ibm,go,2048,eu-de,339,60,279,IBM 2048 MB
ibm,go,2048,eu-de,208,61,147,IBM 2048 MB
ibm,go,2048,eu-de,224,57,167,IBM 2048 MB
ibm,go,2048,eu-de,221,62,159,IBM 2048 MB
ibm,go,2048,eu-de,369,56,313,IBM 2048 MB
ibm,go,2048,eu-de,202,58,144,IBM 2048 MB
ibm,go,2048,eu-de,222,62,160,IBM 2048 MB
ibm,go,2048,eu-de,232,59,173,IBM 2048 MB
ibm,go,2048,eu-de,170,60,110,IBM 2048 MB
ibm,go,2048,eu-de,194,59,135,IBM 2048 MB
ibm,go,2048,eu-de,205,60,145,IBM 2048 MB
ibm,go,2048,eu-de,219,57,162,IBM 2048 MB
ibm,go,2048,eu-de,239,58,181,IBM 2048 MB
ibm,go,2048,eu-de,204,61,143,IBM 2048 MB
ibm,go,2048,eu-de,201,57,144,IBM 2048 MB
ibm,go,2048,eu-de,223,62,161,IBM 2048 MB
ibm,go,2048,eu-de,243,59,184,IBM 2048 MB
ibm,go,2048,eu-de,213,58,155,IBM 2048 MB
ibm,go,2048,eu-de,223,59,164,IBM 2048 MB
ibm,go,2048,eu-de,282,59,223,IBM 2048 MB
ibm,go,2048,eu-de,207,61,146,IBM 2048 MB
ibm,go,2048,eu-de,205,61,144,IBM 2048 MB
ibm,go,2048,eu-de,223,58,165,IBM 2048 MB
ibm,go,2048,eu-de,212,60,152,IBM 2048 MB
ibm,go,2048,eu-de,275,59,216,IBM 2048 MB
ibm,go,2048,eu-de,200,60,140,IBM 2048 MB
ibm,go,2048,eu-de,249,59,190,IBM 2048 MB
ibm,go,2048,eu-de,228,60,168,IBM 2048 MB
ibm,go,2048,eu-de,224,59,165,IBM 2048 MB
ibm,go,2048,eu-de,201,61,140,IBM 2048 MB
ibm,go,2048,eu-de,216,62,154,IBM 2048 MB
