cloud,runtime,memory_mb,region,total_ms,measured_ms,latency_ms,name
google,go,128,europe-west1,1328,1198,130,google-go-128
google,go,128,europe-west1,1238,1096,142,google-go-128
google,go,128,europe-west1,941,808,133,google-go-128
google,go,128,europe-west1,1035,901,134,google-go-128
google,go,128,europe-west1,1037,901,136,google-go-128
google,go,128,europe-west1,933,847,86,google-go-128
google,go,128,europe-west1,1028,956,72,google-go-128
google,go,128,europe-west1,1125,1000,125,google-go-128
google,go,128,europe-west1,1120,1000,120,google-go-128
google,go,128,europe-west1,1021,904,117,google-go-128
google,go,128,europe-west1,1121,908,213,google-go-128
google,go,128,europe-west1,922,842,80,google-go-128
google,go,128,europe-west1,1121,993,128,google-go-128
google,go,128,europe-west1,1015,897,118,google-go-128
google,go,128,europe-west1,1124,1002,122,google-go-128
google,go,128,europe-west1,920,810,110,google-go-128
google,go,128,europe-west1,1365,1207,158,google-go-128
google,go,128,europe-west1,1114,1003,111,google-go-128
google,go,128,europe-west1,1107,1001,106,google-go-128
google,go,128,europe-west1,1109,1005,104,google-go-128
google,go,128,europe-west1,1104,1032,72,google-go-128
google,go,128,europe-west1,812,749,63,google-go-128
google,go,128,europe-west1,1001,896,105,google-go-128
google,go,128,europe-west1,1007,907,100,google-go-128
google,go,128,europe-west1,1001,927,74,google-go-128
google,go,128,europe-west1,1115,1008,107,google-go-128
google,go,128,europe-west1,1091,996,95,google-go-128
google,go,128,europe-west1,993,921,72,google-go-128
google,go,128,europe-west1,992,894,98,google-go-128
google,go,128,europe-west1,993,840,153,google-go-128
google,go,128,europe-west1,988,902,86,google-go-128
google,go,128,europe-west1,1185,997,188,google-go-128
google,go,128,europe-west1,1339,1209,130,google-go-128
google,go,128,europe-west1,1083,1002,81,google-go-128
google,go,128,europe-west1,1178,1096,82,google-go-128
google,go,128,europe-west1,1424,1000,424,google-go-128
google,go,128,europe-west1,1075,995,80,google-go-128
google,go,128,europe-west1,1321,1192,129,google-go-128
google,go,128,europe-west1,984,808,176,google-go-128
google,go,128,europe-west1,1083,1006,77,google-go-128
google,go,128,europe-west1,980,905,75,google-go-128
google,go,128,europe-west1,1082,908,174,google-go-128
google,go,128,europe-west1,1075,1004,71,google-go-128
google,go,128,europe-west1,970,892,78,google-go-128
google,go,128,europe-west1,1267,1003,264,google-go-128
google,go,128,europe-west1,1161,993,168,google-go-128
google,go,128,europe-west1,1069,990,79,google-go-128
google,go,128,europe-west1,1161,997,164,google-go-128
google,go,128,europe-west1,1272,1107,165,google-go-128
google,go,128,europe-west1,1064,905,159,google-go-128
google,go,128,europe-west1,1406,1206,200,google-go-128
google,go,128,europe-west1,1158,993,165,google-go-128
google,go,128,europe-west1,1056,963,93,google-go-128
google,go,128,europe-west1,1162,1004,158,google-go-128
google,go,128,europe-west1,1058,898,160,google-go-128
google,go,128,europe-west1,962,897,65,google-go-128
google,go,128,europe-west1,1057,896,161,google-go-128
google,go,128,europe-west1,1145,985,160,google-go-128
google,go,128,europe-west1,1149,1079,70,google-go-128
google,go,128,europe-west1,1153,1008,145,google-go-128
google,go,128,europe-west1,1250,900,350,google-go-128
google,go,128,europe-west1,1119,906,213,google-go-128
google,go,128,europe-west1,1024,946,78,google-go-128
google,go,128,europe-west1,1128,907,221,google-go-128
google,go,128,europe-west1,1229,1105,124,google-go-128
google,go,128,europe-west1,1024,897,127,google-go-128
google,go,128,europe-west1,1122,1050,72,google-go-128
google,go,128,europe-west1,1023,906,117,google-go-128
google,go,128,europe-west1,915,839,76,google-go-128
google,go,128,europe-west1,924,805,119,google-go-128
google,go,128,europe-west1,1013,894,119,google-go-128
google,go,128,europe-west1,1018,901,117,google-go-128
google,go,128,europe-west1,1022,803,219,google-go-128
google,go,128,europe-west1,1016,902,114,google-go-128
google,go,128,europe-west1,1107,1000,107,google-go-128
google,go,128,europe-west1,1109,990,119,google-go-128
google,go,128,europe-west1,1018,910,108,google-go-128
google,go,128,europe-west1,1262,844,418,google-go-128
google,go,128,europe-west1,1110,994,116,google-go-128
google,go,128,europe-west1,1101,950,151,google-go-128
google,go,128,europe-west1,1106,1041,65,google-go-128
google,go,128,europe-west1,1444,1287,157,google-go-128
google,go,128,europe-west1,1452,1209,243,google-go-128
google,go,128,europe-west1,994,927,67,google-go-128
google,go,128,europe-west1,1092,1002,90,google-go-128
google,go,128,europe-west1,1092,1004,88,google-go-128
google,go,128,europe-west1,996,908,88,google-go-128
google,go,128,europe-west1,1093,1005,88,google-go-128
google,go,128,europe-west1,1087,1024,63,google-go-128
google,go,128,europe-west1,984,904,80,google-go-128
google,go,128,europe-west1,1181,1098,83,google-go-128
google,go,128,europe-west1,996,902,94,google-go-128
google,go,128,europe-west1,997,898,99,google-go-128
google,go,128,europe-west1,796,725,71,google-go-128
google,go,128,europe-west1,1093,1000,93,google-go-128
google,go,128,europe-west1,1086,900,186,google-go-128
google,go,128,europe-west1,1098,1008,90,google-go-128
google,go,128,europe-west1,1290,1194,96,google-go-128
google,go,128,europe-west1,1045,951,94,google-go-128
google,go,128,europe-west1,795,733,62,google-go-128
google,go,256,europe-west1,515,396,119,google-go-256
google,go,256,europe-west1,532,409,123,google-go-256
google,go,256,europe-west1,532,413,119,google-go-256
google,go,256,europe-west1,527,409,118,google-go-256
google,go,256,europe-west1,412,354,58,google-go-256
google,go,256,europe-west1,518,405,113,google-go-256
google,go,256,europe-west1,516,406,110,google-go-256
google,go,256,europe-west1,416,318,98,google-go-256
google,go,256,europe-west1,512,405,107,google-go-256
google,go,256,europe-west1,516,410,106,google-go-256
google,go,256,europe-west1,412,345,67,google-go-256
google,go,256,europe-west1,515,408,107,google-go-256
google,go,256,europe-west1,512,408,104,google-go-256
google,go,256,europe-west1,506,402,104,google-go-256
google,go,256,europe-west1,431,362,69,google-go-256
google,go,256,europe-west1,519,412,107,google-go-256
google,go,256,europe-west1,707,319,388,google-go-256
google,go,256,europe-west1,495,410,85,google-go-256
google,go,256,europe-west1,493,405,88,google-go-256
google,go,256,europe-west1,398,321,77,google-go-256
google,go,256,europe-west1,681,600,81,google-go-256
google,go,256,europe-west1,576,497,79,google-go-256
google,go,256,europe-west1,399,327,72,google-go-256
google,go,256,europe-west1,489,419,70,google-go-256
google,go,256,europe-west1,477,409,68,google-go-256
google,go,256,europe-west1,397,338,59,google-go-256
google,go,256,europe-west1,492,415,77,google-go-256
google,go,256,europe-west1,494,405,89,google-go-256
google,go,256,europe-west1,564,410,154,google-go-256
google,go,256,europe-west1,470,405,65,google-go-256
google,go,256,europe-west1,565,401,164,google-go-256
google,go,256,europe-west1,575,405,170,google-go-256
google,go,256,europe-west1,573,414,159,google-go-256
google,go,256,europe-west1,574,414,160,google-go-256
google,go,256,europe-west1,457,400,57,google-go-256
google,go,256,europe-west1,460,397,63,google-go-256
google,go,256,europe-west1,474,389,85,google-go-256
google,go,256,europe-west1,577,417,160,google-go-256
google,go,256,europe-west1,565,398,167,google-go-256
google,go,256,europe-west1,554,479,75,google-go-256
google,go,256,europe-west1,537,401,136,google-go-256
google,go,256,europe-west1,437,377,60,google-go-256
google,go,256,europe-west1,536,475,61,google-go-256
google,go,256,europe-west1,439,378,61,google-go-256
google,go,256,europe-west1,535,404,131,google-go-256
google,go,256,europe-west1,632,502,130,google-go-256
google,go,256,europe-west1,627,509,118,google-go-256
google,go,256,europe-west1,531,417,114,google-go-256
google,go,256,europe-west1,415,355,60,google-go-256
google,go,256,europe-west1,511,409,102,google-go-256
google,go,256,europe-west1,689,403,286,google-go-256
google,go,256,europe-west1,506,405,101,google-go-256
google,go,256,europe-west1,405,345,60,google-go-256
google,go,256,europe-west1,510,411,99,google-go-256
google,go,256,europe-west1,404,348,56,google-go-256
google,go,256,europe-west1,595,498,97,google-go-256
google,go,256,europe-west1,518,406,112,google-go-256
google,go,256,europe-west1,514,411,103,google-go-256
google,go,256,europe-west1,413,352,61,google-go-256
google,go,256,europe-west1,413,359,54,google-go-256
google,go,256,europe-west1,510,411,99,google-go-256
google,go,256,europe-west1,501,440,61,google-go-256
google,go,256,europe-west1,500,404,96,google-go-256
google,go,256,europe-west1,490,400,90,google-go-256
google,go,256,europe-west1,401,327,74,google-go-256
google,go,256,europe-west1,487,399,88,google-go-256
google,go,256,europe-west1,492,405,87,google-go-256
google,go,256,europe-west1,487,405,82,google-go-256
google,go,256,europe-west1,506,421,85,google-go-256
google,go,256,europe-west1,404,344,60,google-go-256
google,go,256,europe-west1,385,321,64,google-go-256
google,go,256,europe-west1,488,407,81,google-go-256
google,go,256,europe-west1,486,412,74,google-go-256
google,go,256,europe-west1,490,318,172,google-go-256
google,go,256,europe-west1,480,407,73,google-go-256
google,go,256,europe-west1,569,498,71,google-go-256
google,go,256,europe-west1,480,414,66,google-go-256
google,go,256,europe-west1,377,317,60,google-go-256
google,go,256,europe-west1,502,428,74,google-go-256
google,go,256,europe-west1,485,413,72,google-go-256
google,go,256,europe-west1,493,419,74,google-go-256
google,go,256,europe-west1,475,402,73,google-go-256
google,go,256,europe-west1,697,414,283,google-go-256
google,go,256,europe-west1,436,377,59,google-go-256
google,go,256,europe-west1,621,504,117,google-go-256
google,go,256,europe-west1,519,456,63,google-go-256
google,go,256,europe-west1,603,506,97,google-go-256
google,go,256,europe-west1,488,394,94,google-go-256
google,go,256,europe-west1,573,494,79,google-go-256
google,go,256,europe-west1,381,322,59,google-go-256
google,go,256,europe-west1,482,404,78,google-go-256
google,go,256,europe-west1,573,502,71,google-go-256
google,go,256,europe-west1,573,505,68,google-go-256
google,go,256,europe-west1,365,304,61,google-go-256
google,go,256,europe-west1,468,410,58,google-go-256
google,go,256,europe-west1,581,413,168,google-go-256
google,go,256,europe-west1,474,410,64,google-go-256
google,go,256,europe-west1,473,408,65,google-go-256
google,go,256,europe-west1,672,408,264,google-go-256
google,go,256,europe-west1,571,420,151,google-go-256
google,go,512,europe-west1,266,178,88,google-go-512
google,go,512,europe-west1,246,176,70,google-go-512
google,go,512,europe-west1,244,177,67,google-go-512
google,go,512,europe-west1,248,181,67,google-go-512
google,go,512,europe-west1,259,197,62,google-go-512
google,go,512,europe-west1,350,219,131,google-go-512
google,go,512,europe-west1,250,173,77,google-go-512
google,go,512,europe-west1,349,222,127,google-go-512
google,go,512,europe-west1,343,209,134,google-go-512
google,go,512,europe-west1,344,216,128,google-go-512
google,go,512,europe-west1,257,191,66,google-go-512
google,go,512,europe-west1,233,173,60,google-go-512
google,go,512,europe-west1,246,174,72,google-go-512
google,go,512,europe-west1,351,221,130,google-go-512
google,go,512,europe-west1,377,253,124,google-go-512
google,go,512,europe-west1,232,164,68,google-go-512
google,go,512,europe-west1,342,222,120,google-go-512
google,go,512,europe-west1,224,161,63,google-go-512
google,go,512,europe-west1,345,222,123,google-go-512
google,go,512,europe-west1,332,213,119,google-go-512
google,go,512,europe-west1,260,203,57,google-go-512
google,go,512,europe-west1,461,370,91,google-go-512
google,go,512,europe-west1,423,265,158,google-go-512
google,go,512,europe-west1,292,209,83,google-go-512
google,go,512,europe-west1,296,227,69,google-go-512
google,go,512,europe-west1,379,220,159,google-go-512
google,go,512,europe-west1,274,192,82,google-go-512
google,go,512,europe-west1,266,194,72,google-go-512
google,go,512,europe-west1,372,213,159,google-go-512
google,go,512,europe-west1,390,248,142,google-go-512
google,go,512,europe-west1,298,225,73,google-go-512
google,go,512,europe-west1,445,297,148,google-go-512
google,go,512,europe-west1,399,296,103,google-go-512
google,go,512,europe-west1,450,360,90,google-go-512
google,go,512,europe-west1,397,264,133,google-go-512
google,go,512,europe-west1,385,218,167,google-go-512
google,go,512,europe-west1,372,219,153,google-go-512
google,go,512,europe-west1,367,219,148,google-go-512
google,go,512,europe-west1,260,192,68,google-go-512
google,go,512,europe-west1,349,288,61,google-go-512
google,go,512,europe-west1,384,250,134,google-go-512
google,go,512,europe-west1,260,202,58,google-go-512
google,go,512,europe-west1,371,242,129,google-go-512
google,go,512,europe-west1,338,202,136,google-go-512
google,go,512,europe-west1,433,172,261,google-go-512
google,go,512,europe-west1,235,168,67,google-go-512
google,go,512,europe-west1,393,273,120,google-go-512
google,go,512,europe-west1,725,241,484,google-go-512
google,go,512,europe-west1,338,210,128,google-go-512
google,go,512,europe-west1,356,230,126,google-go-512
google,go,512,europe-west1,241,178,63,google-go-512
google,go,512,europe-west1,248,187,61,google-go-512
google,go,512,europe-west1,442,215,227,google-go-512
google,go,512,europe-west1,276,207,69,google-go-512
google,go,512,europe-west1,344,212,132,google-go-512
google,go,512,europe-west1,339,219,120,google-go-512
google,go,512,europe-west1,537,221,316,google-go-512
google,go,512,europe-west1,337,211,126,google-go-512
google,go,512,europe-west1,250,189,61,google-go-512
google,go,512,europe-west1,244,169,75,google-go-512
google,go,512,europe-west1,350,234,116,google-go-512
google,go,512,europe-west1,324,218,106,google-go-512
google,go,512,europe-west1,232,160,72,google-go-512
google,go,512,europe-west1,248,176,72,google-go-512
google,go,512,europe-west1,238,173,65,google-go-512
google,go,512,europe-west1,298,191,107,google-go-512
google,go,512,europe-west1,347,248,99,google-go-512
google,go,512,europe-west1,286,195,91,google-go-512
google,go,512,europe-west1,227,161,66,google-go-512
google,go,512,europe-west1,291,205,86,google-go-512
google,go,512,europe-west1,283,218,65,google-go-512
google,go,512,europe-west1,252,186,66,google-go-512
google,go,512,europe-west1,505,224,281,google-go-512
google,go,512,europe-west1,414,235,179,google-go-512
google,go,512,europe-west1,225,163,62,google-go-512
google,go,512,europe-west1,299,219,80,google-go-512
google,go,512,europe-west1,352,257,95,google-go-512
google,go,512,europe-west1,295,198,97,google-go-512
google,go,512,europe-west1,813,234,579,google-go-512
google,go,512,europe-west1,335,261,74,google-go-512
google,go,512,europe-west1,599,206,393,google-go-512
google,go,512,europe-west1,285,215,70,google-go-512
google,go,512,europe-west1,286,212,74,google-go-512
google,go,512,europe-west1,298,215,83,google-go-512
google,go,512,europe-west1,295,218,77,google-go-512
google,go,512,europe-west1,365,196,169,google-go-512
google,go,512,europe-west1,405,232,173,google-go-512
google,go,512,europe-west1,380,217,163,google-go-512
google,go,512,europe-west1,384,322,62,google-go-512
google,go,512,europe-west1,412,244,168,google-go-512
google,go,512,europe-west1,374,219,155,google-go-512
google,go,512,europe-west1,294,210,84,google-go-512
google,go,512,europe-west1,677,200,477,google-go-512
google,go,512,europe-west1,377,234,143,google-go-512
google,go,512,europe-west1,275,203,72,google-go-512
google,go,512,europe-west1,391,239,152,google-go-512
google,go,512,europe-west1,370,223,147,google-go-512
google,go,512,europe-west1,278,209,69,google-go-512
google,go,512,europe-west1,361,226,135,google-go-512
google,go,512,europe-west1,354,219,135,google-go-512
google,go,1024,europe-west1,157,90,67,google-go-1024
google,go,1024,europe-west1,150,77,73,google-go-1024
google,go,1024,europe-west1,167,102,65,google-go-1024
google,go,1024,europe-west1,153,89,64,google-go-1024
google,go,1024,europe-west1,157,96,61,google-go-1024
google,go,1024,europe-west1,159,90,69,google-go-1024
google,go,1024,europe-west1,198,129,69,google-go-1024
google,go,1024,europe-west1,181,115,66,google-go-1024
google,go,1024,europe-west1,174,102,72,google-go-1024
google,go,1024,europe-west1,175,118,57,google-go-1024
google,go,1024,europe-west1,159,95,64,google-go-1024
google,go,1024,europe-west1,140,79,61,google-go-1024
google,go,1024,europe-west1,195,118,77,google-go-1024
google,go,1024,europe-west1,169,103,66,google-go-1024
google,go,1024,europe-west1,154,86,68,google-go-1024
google,go,1024,europe-west1,207,123,84,google-go-1024
google,go,1024,europe-west1,192,119,73,google-go-1024
google,go,1024,europe-west1,192,109,83,google-go-1024
google,go,1024,europe-west1,222,137,85,google-go-1024
google,go,1024,europe-west1,182,94,88,google-go-1024
google,go,1024,europe-west1,193,122,71,google-go-1024
google,go,1024,europe-west1,181,117,64,google-go-1024
google,go,1024,europe-west1,186,113,73,google-go-1024
google,go,1024,europe-west1,152,93,59,google-go-1024
google,go,1024,europe-west1,177,113,64,google-go-1024
google,go,1024,europe-west1,168,109,59,google-go-1024
google,go,1024,europe-west1,218,140,78,google-go-1024
google,go,1024,europe-west1,197,130,67,google-go-1024
google,go,1024,europe-west1,190,102,88,google-go-1024
google,go,1024,europe-west1,193,132,61,google-go-1024
google,go,1024,europe-west1,177,118,59,google-go-1024
google,go,1024,europe-west1,198,128,70,google-go-1024
google,go,1024,europe-west1,208,128,80,google-go-1024
google,go,1024,europe-west1,168,110,58,google-go-1024
google,go,1024,europe-west1,175,113,62,google-go-1024
google,go,1024,europe-west1,170,110,60,google-go-1024
google,go,1024,europe-west1,167,93,74,google-go-1024
google,go,1024,europe-west1,160,99,61,google-go-1024
google,go,1024,europe-west1,264,120,144,google-go-1024
google,go,1024,europe-west1,260,118,142,google-go-1024
google,go,1024,europe-west1,152,86,66,google-go-1024
google,go,1024,europe-west1,173,108,65,google-go-1024
google,go,1024,europe-west1,246,113,133,google-go-1024
google,go,1024,europe-west1,167,98,69,google-go-1024
google,go,1024,europe-west1,155,97,58,google-go-1024
google,go,1024,europe-west1,261,127,134,google-go-1024
google,go,1024,europe-west1,165,106,59,google-go-1024
google,go,1024,europe-west1,179,112,67,google-go-1024
google,go,1024,europe-west1,184,118,66,google-go-1024
google,go,1024,europe-west1,172,112,60,google-go-1024
google,go,1024,europe-west1,275,142,133,google-go-1024
google,go,1024,europe-west1,171,110,61,google-go-1024
google,go,1024,europe-west1,386,100,286,google-go-1024
google,go,1024,europe-west1,251,126,125,google-go-1024
google,go,1024,europe-west1,241,114,127,google-go-1024
google,go,1024,europe-west1,240,118,122,google-go-1024
google,go,1024,europe-west1,180,102,78,google-go-1024
google,go,1024,europe-west1,235,117,118,google-go-1024
google,go,1024,europe-west1,231,113,118,google-go-1024
google,go,1024,europe-west1,160,99,61,google-go-1024
google,go,1024,europe-west1,243,124,119,google-go-1024
google,go,1024,europe-west1,147,86,61,google-go-1024
google,go,1024,europe-west1,189,119,70,google-go-1024
google,go,1024,europe-west1,166,112,54,google-go-1024
google,go,1024,europe-west1,135,77,58,google-go-1024
google,go,1024,europe-west1,170,107,63,google-go-1024
google,go,1024,europe-west1,147,88,59,google-go-1024
google,go,1024,europe-west1,277,194,83,google-go-1024
google,go,1024,europe-west1,173,100,73,google-go-1024
google,go,1024,europe-west1,152,88,64,google-go-1024
google,go,1024,europe-west1,166,101,65,google-go-1024
google,go,1024,europe-west1,148,92,56,google-go-1024
google,go,1024,europe-west1,346,279,67,google-go-1024
google,go,1024,europe-west1,421,273,148,google-go-1024
google,go,1024,europe-west1,170,108,62,google-go-1024
google,go,1024,europe-west1,209,131,78,google-go-1024
google,go,1024,europe-west1,389,277,112,google-go-1024
google,go,1024,europe-west1,237,119,118,google-go-1024
google,go,1024,europe-west1,165,101,64,google-go-1024
google,go,1024,europe-west1,247,136,111,google-go-1024
google,go,1024,europe-west1,241,129,112,google-go-1024
google,go,1024,europe-west1,165,107,58,google-go-1024
google,go,1024,europe-west1,162,98,64,google-go-1024
google,go,1024,europe-west1,224,110,114,google-go-1024
google,go,1024,europe-west1,166,97,69,google-go-1024
google,go,1024,europe-west1,225,118,107,google-go-1024
google,go,1024,europe-west1,160,93,67,google-go-1024
google,go,1024,europe-west1,317,219,98,google-go-1024
google,go,1024,europe-west1,251,144,107,google-go-1024
google,go,1024,europe-west1,232,124,108,google-go-1024
google,go,1024,europe-west1,152,88,64,google-go-1024
google,go,1024,europe-west1,229,125,104,google-go-1024
google,go,1024,europe-west1,238,135,103,google-go-1024
google,go,1024,europe-west1,155,94,61,google-go-1024
google,go,1024,europe-west1,183,119,64,google-go-1024
google,go,1024,europe-west1,230,130,100,google-go-1024
google,go,1024,europe-west1,166,104,62,google-go-1024
google,go,1024,europe-west1,217,125,92,google-go-1024
google,go,1024,europe-west1,156,92,64,google-go-1024
google,go,1024,europe-west1,154,98,56,google-go-1024
google,go,2048,europe-west1,153,80,73,google-go-2048
google,go,2048,europe-west1,152,83,69,google-go-2048
google,go,2048,europe-west1,141,82,59,google-go-2048
google,go,2048,europe-west1,146,87,59,google-go-2048
google,go,2048,europe-west1,144,76,68,google-go-2048
google,go,2048,europe-west1,336,181,155,google-go-2048
google,go,2048,europe-west1,232,80,152,google-go-2048
google,go,2048,europe-west1,141,82,59,google-go-2048
google,go,2048,europe-west1,221,75,146,google-go-2048
google,go,2048,europe-west1,157,89,68,google-go-2048
google,go,2048,europe-west1,148,86,62,google-go-2048
google,go,2048,europe-west1,153,80,73,google-go-2048
google,go,2048,europe-west1,145,75,70,google-go-2048
google,go,2048,europe-west1,162,97,65,google-go-2048
google,go,2048,europe-west1,223,79,144,google-go-2048
google,go,2048,europe-west1,189,113,76,google-go-2048
google,go,2048,europe-west1,139,77,62,google-go-2048
google,go,2048,europe-west1,150,83,67,google-go-2048
google,go,2048,europe-west1,286,131,155,google-go-2048
google,go,2048,europe-west1,183,111,72,google-go-2048
google,go,2048,europe-west1,222,78,144,google-go-2048
google,go,2048,europe-west1,222,84,138,google-go-2048
google,go,2048,europe-west1,215,79,136,google-go-2048
google,go,2048,europe-west1,213,79,134,google-go-2048
google,go,2048,europe-west1,211,152,59,google-go-2048
google,go,2048,europe-west1,148,79,69,google-go-2048
google,go,2048,europe-west1,210,80,130,google-go-2048
google,go,2048,europe-west1,366,237,129,google-go-2048
google,go,2048,europe-west1,171,108,63,google-go-2048
google,go,2048,europe-west1,211,89,122,google-go-2048
google,go,2048,europe-west1,208,81,127,google-go-2048
google,go,2048,europe-west1,145,78,67,google-go-2048
google,go,2048,europe-west1,214,103,111,google-go-2048
google,go,2048,europe-west1,164,81,83,google-go-2048
google,go,2048,europe-west1,138,79,59,google-go-2048
google,go,2048,europe-west1,186,129,57,google-go-2048
google,go,2048,europe-west1,194,83,111,google-go-2048
google,go,2048,europe-west1,188,127,61,google-go-2048
google,go,2048,europe-west1,181,85,96,google-go-2048
google,go,2048,europe-west1,177,115,62,google-go-2048
google,go,2048,europe-west1,370,254,116,google-go-2048
google,go,2048,europe-west1,193,97,96,google-go-2048
google,go,2048,europe-west1,171,110,61,google-go-2048
google,go,2048,europe-west1,163,76,87,google-go-2048
google,go,2048,europe-west1,163,80,83,google-go-2048
google,go,2048,europe-west1,191,101,90,google-go-2048
google,go,2048,europe-west1,172,108,64,google-go-2048
google,go,2048,europe-west1,201,134,67,google-go-2048
google,go,2048,europe-west1,226,165,61,google-go-2048
google,go,2048,europe-west1,582,405,177,google-go-2048
google,go,2048,europe-west1,1188,79,1109,google-go-2048
google,go,2048,europe-west1,181,121,60,google-go-2048
google,go,2048,europe-west1,200,112,88,google-go-2048
google,go,2048,europe-west1,142,77,65,google-go-2048
google,go,2048,europe-west1,209,112,97,google-go-2048
google,go,2048,europe-west1,182,119,63,google-go-2048
google,go,2048,europe-west1,294,176,118,google-go-2048
google,go,2048,europe-west1,186,125,61,google-go-2048
google,go,2048,europe-west1,305,142,163,google-go-2048
google,go,2048,europe-west1,156,90,66,google-go-2048
google,go,2048,europe-west1,162,100,62,google-go-2048
google,go,2048,europe-west1,664,109,555,google-go-2048
google,go,2048,europe-west1,217,129,88,google-go-2048
google,go,2048,europe-west1,300,221,79,google-go-2048
google,go,2048,europe-west1,171,101,70,google-go-2048
google,go,2048,europe-west1,159,100,59,google-go-2048
google,go,2048,europe-west1,206,148,58,google-go-2048
google,go,2048,europe-west1,216,88,128,google-go-2048
google,go,2048,europe-west1,152,80,72,google-go-2048
google,go,2048,europe-west1,214,141,73,google-go-2048
google,go,2048,europe-west1,259,134,125,google-go-2048
google,go,2048,europe-west1,227,93,134,google-go-2048
google,go,2048,europe-west1,128,75,53,google-go-2048
google,go,2048,europe-west1,286,218,68,google-go-2048
google,go,2048,europe-west1,217,96,121,google-go-2048
google,go,2048,europe-west1,146,92,54,google-go-2048
google,go,2048,europe-west1,190,99,91,google-go-2048
google,go,2048,europe-west1,164,96,68,google-go-2048
google,go,2048,europe-west1,309,227,82,google-go-2048
google,go,2048,europe-west1,156,91,65,google-go-2048
google,go,2048,europe-west1,203,116,87,google-go-2048
google,go,2048,europe-west1,310,167,143,google-go-2048
google,go,2048,europe-west1,167,100,67,google-go-2048
google,go,2048,europe-west1,172,107,65,google-go-2048
google,go,2048,europe-west1,464,362,102,google-go-2048
google,go,2048,europe-west1,223,147,76,google-go-2048
google,go,2048,europe-west1,336,244,92,google-go-2048
google,go,2048,europe-west1,293,150,143,google-go-2048
google,go,2048,europe-west1,183,103,80,google-go-2048
google,go,2048,europe-west1,187,118,69,google-go-2048
google,go,2048,europe-west1,159,95,64,google-go-2048
google,go,2048,europe-west1,269,124,145,google-go-2048
google,go,2048,europe-west1,176,110,66,google-go-2048
google,go,2048,europe-west1,197,129,68,google-go-2048
google,go,2048,europe-west1,190,117,73,google-go-2048
google,go,2048,europe-west1,413,102,311,google-go-2048
google,go,2048,europe-west1,192,119,73,google-go-2048
google,go,2048,europe-west1,185,120,65,google-go-2048
google,go,2048,europe-west1,302,226,76,google-go-2048
google,go,2048,europe-west1,208,137,71,google-go-2048
google,node,128,europe-west1,8533,4519,4014,google-node-128
google,node,128,europe-west1,7933,4414,3519,google-node-128
google,node,128,europe-west1,5021,2822,2199,google-node-128
google,node,128,europe-west1,21870,21596,274,google-node-128
google,node,128,europe-west1,5495,2943,2552,google-node-128
google,node,128,europe-west1,17274,17056,218,google-node-128
google,node,128,europe-west1,6097,3494,2603,google-node-128
google,node,128,europe-west1,19571,19069,502,google-node-128
google,node,128,europe-west1,18765,18514,251,google-node-128
google,node,128,europe-west1,18664,18500,164,google-node-128
google,node,128,europe-west1,17571,17448,123,google-node-128
google,node,128,europe-west1,17889,17742,147,google-node-128
google,node,128,europe-west1,17070,16948,122,google-node-128
google,node,128,europe-west1,18964,18298,666,google-node-128
google,node,128,europe-west1,17356,17227,129,google-node-128
google,node,128,europe-west1,19365,17208,2157,google-node-128
google,node,128,europe-west1,22871,22740,131,google-node-128
google,node,128,europe-west1,19160,19018,142,google-node-128
google,node,128,europe-west1,24565,24384,181,google-node-128
google,node,128,europe-west1,17851,17605,246,google-node-128
google,node,128,europe-west1,24467,24208,259,google-node-128
google,node,128,europe-west1,24562,24388,174,google-node-128
google,node,128,europe-west1,18154,18024,130,google-node-128
google,node,128,europe-west1,23957,23601,356,google-node-128
google,node,128,europe-west1,18548,18392,156,google-node-128
google,node,128,europe-west1,24063,23902,161,google-node-128
google,node,128,europe-west1,26145,25818,327,google-node-128
google,node,128,europe-west1,23570,23347,223,google-node-128
google,node,128,europe-west1,20839,20689,150,google-node-128
google,node,128,europe-west1,20946,20798,148,google-node-128
google,node,128,europe-west1,22379,22101,278,google-node-128
google,node,128,europe-west1,19334,19104,230,google-node-128
google,node,128,europe-west1,23666,23516,150,google-node-128
google,node,128,europe-west1,18331,18194,137,google-node-128
google,node,128,europe-west1,24868,24655,213,google-node-128
google,node,128,europe-west1,6000,3285,2715,google-node-128
google,node,128,europe-west1,5343,3065,2278,google-node-128
google,node,128,europe-west1,17229,17093,136,google-node-128
google,node,128,europe-west1,22842,22395,447,google-node-128
google,node,128,europe-west1,22332,22145,187,google-node-128
google,node,128,europe-west1,16019,15697,322,google-node-128
google,node,128,europe-west1,21834,21667,167,google-node-128
google,node,128,europe-west1,15180,14995,185,google-node-128
google,node,128,europe-west1,15019,14700,319,google-node-128
google,node,128,europe-west1,20824,20593,231,google-node-128
google,node,128,europe-west1,19318,19188,130,google-node-128
google,node,128,europe-west1,14564,14395,169,google-node-128
google,node,128,europe-west1,16213,15997,216,google-node-128
google,node,128,europe-west1,15106,14896,210,google-node-128
google,node,128,europe-west1,18812,18599,213,google-node-128
google,node,128,europe-west1,14863,14734,129,google-node-128
google,node,128,europe-west1,14900,14509,391,google-node-128
google,node,128,europe-west1,16108,15804,304,google-node-128
google,node,128,europe-west1,14818,14685,133,google-node-128
google,node,128,europe-west1,20522,20202,320,google-node-128
google,node,128,europe-west1,15554,15401,153,google-node-128
google,node,128,europe-west1,20811,20671,140,google-node-128
google,node,128,europe-west1,14400,14248,152,google-node-128
google,node,128,europe-west1,15698,15488,210,google-node-128
google,node,128,europe-west1,16252,15206,1046,google-node-128
google,node,128,europe-west1,14779,14645,134,google-node-128
google,node,128,europe-west1,16875,16605,270,google-node-128
google,node,128,europe-west1,15477,15290,187,google-node-128
google,node,128,europe-west1,14564,14393,171,google-node-128
google,node,128,europe-west1,15451,15314,137,google-node-128
google,node,128,europe-west1,17286,17142,144,google-node-128
google,node,128,europe-west1,15164,15045,119,google-node-128
google,node,128,europe-west1,15066,14933,133,google-node-128
google,node,128,europe-west1,15918,15688,230,google-node-128
google,node,128,europe-west1,16678,16554,124,google-node-128
google,node,128,europe-west1,14565,14402,163,google-node-128
google,node,128,europe-west1,15263,15087,176,google-node-128
google,node,128,europe-west1,16217,16097,120,google-node-128
google,node,128,europe-west1,16571,16441,130,google-node-128
google,node,128,europe-west1,15055,14936,119,google-node-128
google,node,128,europe-west1,15963,15701,262,google-node-128
google,node,128,europe-west1,16512,16285,227,google-node-128
google,node,128,europe-west1,14751,14637,114,google-node-128
google,node,128,europe-west1,17563,17422,141,google-node-128
google,node,128,europe-west1,14659,14491,168,google-node-128
google,node,128,europe-west1,15147,14603,544,google-node-128
google,node,128,europe-west1,15893,15579,314,google-node-128
google,node,128,europe-west1,14354,14201,153,google-node-128
google,node,128,europe-west1,16849,16729,120,google-node-128
google,node,128,europe-west1,15039,14806,233,google-node-128
google,node,128,europe-west1,15138,15008,130,google-node-128
google,node,128,europe-west1,16094,15901,193,google-node-128
google,node,128,europe-west1,17446,17318,128,google-node-128
google,node,128,europe-west1,15493,14889,604,google-node-128
google,node,128,europe-west1,16029,15898,131,google-node-128
google,node,128,europe-west1,15290,15097,193,google-node-128
google,node,128,europe-west1,16047,15900,147,google-node-128
google,node,128,europe-west1,17256,17089,167,google-node-128
google,node,128,europe-west1,15051,14932,119,google-node-128
google,node,128,europe-west1,15694,15574,120,google-node-128
google,node,128,europe-west1,15536,15385,151,google-node-128
google,node,128,europe-west1,15439,15306,133,google-node-128
google,node,128,europe-west1,16944,16798,146,google-node-128
google,node,128,europe-west1,14852,14716,136,google-node-128
google,node,128,europe-west1,14829,14701,128,google-node-128
google,node,256,europe-west1,5243,2715,2528,google-node-256
google,node,256,europe-west1,6327,6214,113,google-node-256
google,node,256,europe-west1,7733,6387,1346,google-node-256
google,node,256,europe-west1,9013,6204,2809,google-node-256
google,node,256,europe-west1,10126,6100,4026,google-node-256
google,node,256,europe-west1,12006,6791,5215,google-node-256
google,node,256,europe-west1,10449,3004,7445,google-node-256
google,node,256,europe-west1,10500,8484,2016,google-node-256
google,node,256,europe-west1,8903,8446,457,google-node-256
google,node,256,europe-west1,8026,7504,522,google-node-256
google,node,256,europe-west1,7715,7520,195,google-node-256
google,node,256,europe-west1,8392,8187,205,google-node-256
google,node,256,europe-west1,8679,8204,475,google-node-256
google,node,256,europe-west1,9099,8988,111,google-node-256
google,node,256,europe-west1,9696,9577,119,google-node-256
google,node,256,europe-west1,10374,9978,396,google-node-256
google,node,256,europe-west1,10699,10258,441,google-node-256
google,node,256,europe-west1,8884,8422,462,google-node-256
google,node,256,europe-west1,7939,7807,132,google-node-256
google,node,256,europe-west1,8379,8198,181,google-node-256
google,node,256,europe-west1,8088,7898,190,google-node-256
google,node,256,europe-west1,8550,8188,362,google-node-256
google,node,256,europe-west1,11422,8001,3421,google-node-256
google,node,256,europe-west1,10322,2849,7473,google-node-256
google,node,256,europe-west1,15324,8895,6429,google-node-256
google,node,256,europe-west1,10815,10478,337,google-node-256
google,node,256,europe-west1,17409,12009,5400,google-node-256
google,node,256,europe-west1,17127,11222,5905,google-node-256
google,node,256,europe-west1,7854,7733,121,google-node-256
google,node,256,europe-west1,13517,11025,2492,google-node-256
google,node,256,europe-west1,7467,7336,131,google-node-256
google,node,256,europe-west1,9401,9275,126,google-node-256
google,node,256,europe-west1,9225,9088,137,google-node-256
google,node,256,europe-west1,7663,7548,115,google-node-256
google,node,256,europe-west1,8470,8302,168,google-node-256
google,node,256,europe-west1,8796,8390,406,google-node-256
google,node,256,europe-west1,7626,7438,188,google-node-256
google,node,256,europe-west1,8794,8587,207,google-node-256
google,node,256,europe-west1,7054,6926,128,google-node-256
google,node,256,europe-west1,7834,7713,121,google-node-256
google,node,256,europe-west1,7438,7280,158,google-node-256
google,node,256,europe-west1,9477,9359,118,google-node-256
google,node,256,europe-west1,9383,9264,119,google-node-256
google,node,256,europe-west1,6730,6612,118,google-node-256
google,node,256,europe-west1,9382,9257,125,google-node-256
google,node,256,europe-west1,11760,11590,170,google-node-256
google,node,256,europe-west1,10057,9934,123,google-node-256
google,node,256,europe-west1,6909,6698,211,google-node-256
google,node,256,europe-west1,9650,9532,118,google-node-256
google,node,256,europe-west1,9760,9613,147,google-node-256
google,node,256,europe-west1,7015,6802,213,google-node-256
google,node,256,europe-west1,8933,8786,147,google-node-256
google,node,256,europe-west1,9542,9390,152,google-node-256
google,node,256,europe-west1,6907,6800,107,google-node-256
google,node,256,europe-west1,7085,6965,120,google-node-256
google,node,256,europe-west1,8331,7726,605,google-node-256
google,node,256,europe-west1,6696,6578,118,google-node-256
google,node,256,europe-west1,7764,7416,348,google-node-256
google,node,256,europe-west1,7009,6810,199,google-node-256
google,node,256,europe-west1,7733,7627,106,google-node-256
google,node,256,europe-west1,7590,7481,109,google-node-256
google,node,256,europe-west1,7594,7474,120,google-node-256
google,node,256,europe-west1,8934,8795,139,google-node-256
google,node,256,europe-west1,10924,10776,148,google-node-256
google,node,256,europe-west1,9741,9618,123,google-node-256
google,node,256,europe-west1,7599,7456,143,google-node-256
google,node,256,europe-west1,8177,8062,115,google-node-256
google,node,256,europe-west1,7778,7644,134,google-node-256
google,node,256,europe-west1,7192,7076,116,google-node-256
google,node,256,europe-west1,8721,8594,127,google-node-256
google,node,256,europe-west1,9017,8878,139,google-node-256
google,node,256,europe-west1,7280,6859,421,google-node-256
google,node,256,europe-west1,8525,8389,136,google-node-256
google,node,256,europe-west1,7874,7603,271,google-node-256
google,node,256,europe-west1,7780,7604,176,google-node-256
google,node,256,europe-west1,7618,7402,216,google-node-256
google,node,256,europe-west1,7666,7481,185,google-node-256
google,node,256,europe-west1,9131,8589,542,google-node-256
google,node,256,europe-west1,7863,7758,105,google-node-256
google,node,256,europe-west1,7511,7307,204,google-node-256
google,node,256,europe-west1,7556,7449,107,google-node-256
google,node,256,europe-west1,8623,8407,216,google-node-256
google,node,256,europe-west1,8692,8541,151,google-node-256
google,node,256,europe-west1,7624,7514,110,google-node-256
google,node,256,europe-west1,8609,8486,123,google-node-256
google,node,256,europe-west1,7809,7694,115,google-node-256
google,node,256,europe-west1,9341,9221,120,google-node-256
google,node,256,europe-west1,11128,10890,238,google-node-256
google,node,256,europe-west1,10806,10683,123,google-node-256
google,node,256,europe-west1,12505,11302,1203,google-node-256
google,node,256,europe-west1,10927,10097,830,google-node-256
google,node,256,europe-west1,7576,7411,165,google-node-256
google,node,256,europe-west1,10013,9881,132,google-node-256
google,node,256,europe-west1,9723,9506,217,google-node-256
google,node,256,europe-west1,8160,7988,172,google-node-256
google,node,256,europe-west1,10065,9919,146,google-node-256
google,node,256,europe-west1,11275,11165,110,google-node-256
google,node,256,europe-west1,10966,10847,119,google-node-256
google,node,256,europe-west1,12455,11104,1351,google-node-256
google,node,256,europe-west1,10243,9273,970,google-node-256
google,node,512,europe-west1,3724,3495,229,google-node-512
google,node,512,europe-west1,3550,3420,130,google-node-512
google,node,512,europe-west1,4020,2088,1932,google-node-512
google,node,512,europe-west1,3385,3275,110,google-node-512
google,node,512,europe-west1,3306,3193,113,google-node-512
google,node,512,europe-west1,3677,3501,176,google-node-512
google,node,512,europe-west1,3411,3302,109,google-node-512
google,node,512,europe-west1,3613,3439,174,google-node-512
google,node,512,europe-west1,3612,3450,162,google-node-512
google,node,512,europe-west1,3692,3581,111,google-node-512
google,node,512,europe-west1,3786,3615,171,google-node-512
google,node,512,europe-west1,3280,3116,164,google-node-512
google,node,512,europe-west1,3265,3107,158,google-node-512
google,node,512,europe-west1,3368,3208,160,google-node-512
google,node,512,europe-west1,3459,3293,166,google-node-512
google,node,512,europe-west1,3408,3238,170,google-node-512
google,node,512,europe-west1,3377,3228,149,google-node-512
google,node,512,europe-west1,3486,3324,162,google-node-512
google,node,512,europe-west1,3390,3264,126,google-node-512
google,node,512,europe-west1,3370,3211,159,google-node-512
google,node,512,europe-west1,3795,3572,223,google-node-512
google,node,512,europe-west1,3496,3283,213,google-node-512
google,node,512,europe-west1,3510,3318,192,google-node-512
google,node,512,europe-west1,3503,3305,198,google-node-512
google,node,512,europe-west1,3432,3240,192,google-node-512
google,node,512,europe-west1,3312,3122,190,google-node-512
google,node,512,europe-west1,3490,3302,188,google-node-512
google,node,512,europe-west1,3514,3392,122,google-node-512
google,node,512,europe-west1,3526,3336,190,google-node-512
google,node,512,europe-west1,3904,3427,477,google-node-512
google,node,512,europe-west1,3819,3625,194,google-node-512
google,node,512,europe-west1,3517,3320,197,google-node-512
google,node,512,europe-west1,3468,3314,154,google-node-512
google,node,512,europe-west1,3799,3586,213,google-node-512
google,node,512,europe-west1,3826,3651,175,google-node-512
google,node,512,europe-west1,3572,3381,191,google-node-512
google,node,512,europe-west1,3685,3503,182,google-node-512
google,node,512,europe-west1,3913,3732,181,google-node-512
google,node,512,europe-west1,3880,3697,183,google-node-512
google,node,512,europe-west1,3871,3704,167,google-node-512
google,node,512,europe-west1,3596,3418,178,google-node-512
google,node,512,europe-west1,3571,3397,174,google-node-512
google,node,512,europe-west1,3663,3503,160,google-node-512
google,node,512,europe-west1,3657,3487,170,google-node-512
google,node,512,europe-west1,3876,3710,166,google-node-512
google,node,512,europe-west1,3681,3517,164,google-node-512
google,node,512,europe-west1,4605,4452,153,google-node-512
google,node,512,europe-west1,3599,3479,120,google-node-512
google,node,512,europe-west1,3405,3246,159,google-node-512
google,node,512,europe-west1,3694,3289,405,google-node-512
google,node,512,europe-west1,3489,3321,168,google-node-512
google,node,512,europe-west1,3685,3528,157,google-node-512
google,node,512,europe-west1,3869,3512,357,google-node-512
google,node,512,europe-west1,4207,4039,168,google-node-512
google,node,512,europe-west1,3579,3462,117,google-node-512
google,node,512,europe-west1,3672,3509,163,google-node-512
google,node,512,europe-west1,3866,3557,309,google-node-512
google,node,512,europe-west1,4124,3949,175,google-node-512
google,node,512,europe-west1,3866,3704,162,google-node-512
google,node,512,europe-west1,3487,3365,122,google-node-512
google,node,512,europe-west1,3782,3633,149,google-node-512
google,node,512,europe-west1,3736,3590,146,google-node-512
google,node,512,europe-west1,3672,3536,136,google-node-512
google,node,512,europe-west1,3553,3409,144,google-node-512
google,node,512,europe-west1,3648,3530,118,google-node-512
google,node,512,europe-west1,3648,3510,138,google-node-512
google,node,512,europe-west1,3664,3527,137,google-node-512
google,node,512,europe-west1,3626,3399,227,google-node-512
google,node,512,europe-west1,3545,3425,120,google-node-512
google,node,512,europe-west1,3640,3520,120,google-node-512
google,node,512,europe-west1,3453,3339,114,google-node-512
google,node,512,europe-west1,5047,4886,161,google-node-512
google,node,512,europe-west1,4216,3882,334,google-node-512
google,node,512,europe-west1,4060,3843,217,google-node-512
google,node,512,europe-west1,4429,4289,140,google-node-512
google,node,512,europe-west1,5746,5476,270,google-node-512
google,node,512,europe-west1,5323,4554,769,google-node-512
google,node,512,europe-west1,3566,3415,151,google-node-512
google,node,512,europe-west1,3917,3353,564,google-node-512
google,node,512,europe-west1,3482,3379,103,google-node-512
google,node,512,europe-west1,3760,3288,472,google-node-512
google,node,512,europe-west1,3366,3260,106,google-node-512
google,node,512,europe-west1,3471,3346,125,google-node-512
google,node,512,europe-west1,3676,3520,156,google-node-512
google,node,512,europe-west1,3485,3325,160,google-node-512
google,node,512,europe-west1,3578,3427,151,google-node-512
google,node,512,europe-west1,4042,3882,160,google-node-512
google,node,512,europe-west1,3453,3342,111,google-node-512
google,node,512,europe-west1,3553,3393,160,google-node-512
google,node,512,europe-west1,3733,3420,313,google-node-512
google,node,512,europe-west1,3545,3437,108,google-node-512
google,node,512,europe-west1,3464,3342,122,google-node-512
google,node,512,europe-west1,3562,3324,238,google-node-512
google,node,512,europe-west1,3446,3344,102,google-node-512
google,node,512,europe-west1,3459,3348,111,google-node-512
google,node,512,europe-west1,3354,3219,135,google-node-512
google,node,512,europe-west1,3430,3307,123,google-node-512
google,node,512,europe-west1,3520,3291,229,google-node-512
google,node,512,europe-west1,3347,3241,106,google-node-512
google,node,512,europe-west1,3400,3279,121,google-node-512
google,node,1024,europe-west1,2278,1918,360,google-node-1024
google,node,1024,europe-west1,2537,2308,229,google-node-1024
google,node,1024,europe-west1,2229,2040,189,google-node-1024
google,node,1024,europe-west1,2060,1874,186,google-node-1024
google,node,1024,europe-west1,2126,1928,198,google-node-1024
google,node,1024,europe-west1,2067,1923,144,google-node-1024
google,node,1024,europe-west1,2146,1969,177,google-node-1024
google,node,1024,europe-west1,1998,1862,136,google-node-1024
google,node,1024,europe-west1,2083,1907,176,google-node-1024
google,node,1024,europe-west1,1962,1851,111,google-node-1024
google,node,1024,europe-west1,1988,1851,137,google-node-1024
google,node,1024,europe-west1,2046,1869,177,google-node-1024
google,node,1024,europe-west1,1986,1821,165,google-node-1024
google,node,1024,europe-west1,2303,2134,169,google-node-1024
google,node,1024,europe-west1,2000,1834,166,google-node-1024
google,node,1024,europe-west1,2087,1921,166,google-node-1024
google,node,1024,europe-west1,2033,1872,161,google-node-1024
google,node,1024,europe-west1,2357,2182,175,google-node-1024
google,node,1024,europe-west1,2260,2155,105,google-node-1024
google,node,1024,europe-west1,1996,1862,134,google-node-1024
google,node,1024,europe-west1,2109,1976,133,google-node-1024
google,node,1024,europe-west1,2006,1837,169,google-node-1024
google,node,1024,europe-west1,1971,1820,151,google-node-1024
google,node,1024,europe-west1,1987,1835,152,google-node-1024
google,node,1024,europe-west1,1958,1812,146,google-node-1024
google,node,1024,europe-west1,1911,1820,91,google-node-1024
google,node,1024,europe-west1,1973,1825,148,google-node-1024
google,node,1024,europe-west1,2147,2003,144,google-node-1024
google,node,1024,europe-west1,2610,2002,608,google-node-1024
google,node,1024,europe-west1,2202,2058,144,google-node-1024
google,node,1024,europe-west1,1972,1825,147,google-node-1024
google,node,1024,europe-west1,1829,1771,58,google-node-1024
google,node,1024,europe-west1,2002,1906,96,google-node-1024
google,node,1024,europe-west1,1887,1748,139,google-node-1024
google,node,1024,europe-west1,1948,1812,136,google-node-1024
google,node,1024,europe-west1,1965,1829,136,google-node-1024
google,node,1024,europe-west1,1901,1760,141,google-node-1024
google,node,1024,europe-west1,2408,2279,129,google-node-1024
google,node,1024,europe-west1,1886,1824,62,google-node-1024
google,node,1024,europe-west1,1969,1842,127,google-node-1024
google,node,1024,europe-west1,2063,1987,76,google-node-1024
google,node,1024,europe-west1,2006,1888,118,google-node-1024
google,node,1024,europe-west1,2023,1917,106,google-node-1024
google,node,1024,europe-west1,2058,1941,117,google-node-1024
google,node,1024,europe-west1,1972,1856,116,google-node-1024
google,node,1024,europe-west1,2031,1818,213,google-node-1024
google,node,1024,europe-west1,2016,1907,109,google-node-1024
google,node,1024,europe-west1,2015,1909,106,google-node-1024
google,node,1024,europe-west1,2079,1975,104,google-node-1024
google,node,1024,europe-west1,2154,2042,112,google-node-1024
google,node,1024,europe-west1,2220,1860,360,google-node-1024
google,node,1024,europe-west1,2388,2285,103,google-node-1024
google,node,1024,europe-west1,2240,1835,405,google-node-1024
google,node,1024,europe-west1,2068,1903,165,google-node-1024
google,node,1024,europe-west1,2176,1838,338,google-node-1024
google,node,1024,europe-west1,2031,1867,164,google-node-1024
google,node,1024,europe-west1,1978,1777,201,google-node-1024
google,node,1024,europe-west1,2101,1896,205,google-node-1024
google,node,1024,europe-west1,2039,1838,201,google-node-1024
google,node,1024,europe-west1,2039,1841,198,google-node-1024
google,node,1024,europe-west1,1968,1764,204,google-node-1024
google,node,1024,europe-west1,1900,1799,101,google-node-1024
google,node,1024,europe-west1,1868,1796,72,google-node-1024
google,node,1024,europe-west1,2049,1797,252,google-node-1024
google,node,1024,europe-west1,2347,1835,512,google-node-1024
google,node,1024,europe-west1,1892,1824,68,google-node-1024
google,node,1024,europe-west1,1848,1733,115,google-node-1024
google,node,1024,europe-west1,2156,1809,347,google-node-1024
google,node,1024,europe-west1,2059,1856,203,google-node-1024
google,node,1024,europe-west1,1939,1830,109,google-node-1024
google,node,1024,europe-west1,1882,1774,108,google-node-1024
google,node,1024,europe-west1,2076,1869,207,google-node-1024
google,node,1024,europe-west1,2517,1811,706,google-node-1024
google,node,1024,europe-west1,1926,1795,131,google-node-1024
google,node,1024,europe-west1,2027,1834,193,google-node-1024
google,node,1024,europe-west1,1928,1828,100,google-node-1024
google,node,1024,europe-west1,2024,1826,198,google-node-1024
google,node,1024,europe-west1,1998,1744,254,google-node-1024
google,node,1024,europe-west1,1936,1821,115,google-node-1024
google,node,1024,europe-west1,2238,2126,112,google-node-1024
google,node,1024,europe-west1,2085,1959,126,google-node-1024
google,node,1024,europe-west1,1875,1685,190,google-node-1024
google,node,1024,europe-west1,1901,1793,108,google-node-1024
google,node,1024,europe-west1,1961,1764,197,google-node-1024
google,node,1024,europe-west1,1850,1742,108,google-node-1024
google,node,1024,europe-west1,2564,2368,196,google-node-1024
google,node,1024,europe-west1,1862,1753,109,google-node-1024
google,node,1024,europe-west1,1870,1756,114,google-node-1024
google,node,1024,europe-west1,1928,1743,185,google-node-1024
google,node,1024,europe-west1,1997,1809,188,google-node-1024
google,node,1024,europe-west1,2082,2008,74,google-node-1024
google,node,1024,europe-west1,2011,1829,182,google-node-1024
google,node,1024,europe-west1,1893,1782,111,google-node-1024
google,node,1024,europe-west1,1938,1741,197,google-node-1024
google,node,1024,europe-west1,2304,1859,445,google-node-1024
google,node,1024,europe-west1,1968,1827,141,google-node-1024
google,node,1024,europe-west1,2314,1774,540,google-node-1024
google,node,1024,europe-west1,2561,2268,293,google-node-1024
google,node,1024,europe-west1,2056,1942,114,google-node-1024
google,node,1024,europe-west1,1993,1929,64,google-node-1024
google,node,2048,europe-west1,3260,3084,176,google-node-2048
google,node,2048,europe-west1,1909,1751,158,google-node-2048
google,node,2048,europe-west1,1811,1660,151,google-node-2048
google,node,2048,europe-west1,1575,1469,106,google-node-2048
google,node,2048,europe-west1,1638,1515,123,google-node-2048
google,node,2048,europe-west1,1723,1629,94,google-node-2048
google,node,2048,europe-west1,1676,1606,70,google-node-2048
google,node,2048,europe-west1,1571,1513,58,google-node-2048
google,node,2048,europe-west1,1619,1488,131,google-node-2048
google,node,2048,europe-west1,1628,1551,77,google-node-2048
google,node,2048,europe-west1,1647,1512,135,google-node-2048
google,node,2048,europe-west1,1498,1425,73,google-node-2048
google,node,2048,europe-west1,1686,1604,82,google-node-2048
google,node,2048,europe-west1,2133,2006,127,google-node-2048
google,node,2048,europe-west1,1630,1511,119,google-node-2048
google,node,2048,europe-west1,1609,1546,63,google-node-2048
google,node,2048,europe-west1,1667,1553,114,google-node-2048
google,node,2048,europe-west1,1862,1751,111,google-node-2048
google,node,2048,europe-west1,1868,1756,112,google-node-2048
google,node,2048,europe-west1,2385,2029,356,google-node-2048
google,node,2048,europe-west1,1727,1549,178,google-node-2048
google,node,2048,europe-west1,1609,1544,65,google-node-2048
google,node,2048,europe-west1,1589,1473,116,google-node-2048
google,node,2048,europe-west1,1552,1477,75,google-node-2048
google,node,2048,europe-west1,1427,1346,81,google-node-2048
google,node,2048,europe-west1,1945,1731,214,google-node-2048
google,node,2048,europe-west1,1527,1438,89,google-node-2048
google,node,2048,europe-west1,1630,1522,108,google-node-2048
google,node,2048,europe-west1,1600,1439,161,google-node-2048
google,node,2048,europe-west1,1496,1428,68,google-node-2048
google,node,2048,europe-west1,2059,1852,207,google-node-2048
google,node,2048,europe-west1,1735,1537,198,google-node-2048
google,node,2048,europe-west1,1613,1547,66,google-node-2048
google,node,2048,europe-west1,1710,1566,144,google-node-2048
google,node,2048,europe-west1,1832,1650,182,google-node-2048
google,node,2048,europe-west1,1524,1459,65,google-node-2048
google,node,2048,europe-west1,1562,1423,139,google-node-2048
google,node,2048,europe-west1,1942,1760,182,google-node-2048
google,node,2048,europe-west1,1651,1577,74,google-node-2048
google,node,2048,europe-west1,1679,1546,133,google-node-2048
google,node,2048,europe-west1,1587,1403,184,google-node-2048
google,node,2048,europe-west1,1552,1489,63,google-node-2048
google,node,2048,europe-west1,2638,2347,291,google-node-2048
google,node,2048,europe-west1,5199,5028,171,google-node-2048
google,node,2048,europe-west1,5926,5634,292,google-node-2048
google,node,2048,europe-west1,5290,4294,996,google-node-2048
google,node,2048,europe-west1,3053,1583,1470,google-node-2048
google,node,2048,europe-west1,1673,1541,132,google-node-2048
google,node,2048,europe-west1,1818,1677,141,google-node-2048
google,node,2048,europe-west1,3300,3140,160,google-node-2048
google,node,2048,europe-west1,1983,1847,136,google-node-2048
google,node,2048,europe-west1,1572,1496,76,google-node-2048
google,node,2048,europe-west1,1682,1542,140,google-node-2048
google,node,2048,europe-west1,1699,1535,164,google-node-2048
google,node,2048,europe-west1,1680,1608,72,google-node-2048
google,node,2048,europe-west1,1656,1585,71,google-node-2048
google,node,2048,europe-west1,1773,1560,213,google-node-2048
google,node,2048,europe-west1,1764,1653,111,google-node-2048
google,node,2048,europe-west1,1834,1630,204,google-node-2048
google,node,2048,europe-west1,1815,1608,207,google-node-2048
google,node,2048,europe-west1,1586,1521,65,google-node-2048
google,node,2048,europe-west1,2365,1765,600,google-node-2048
google,node,2048,europe-west1,1697,1552,145,google-node-2048
google,node,2048,europe-west1,1803,1669,134,google-node-2048
google,node,2048,europe-west1,1634,1443,191,google-node-2048
google,node,2048,europe-west1,2250,2059,191,google-node-2048
google,node,2048,europe-west1,1692,1628,64,google-node-2048
google,node,2048,europe-west1,1728,1596,132,google-node-2048
google,node,2048,europe-west1,1762,1640,122,google-node-2048
google,node,2048,europe-west1,1821,1654,167,google-node-2048
google,node,2048,europe-west1,1795,1630,165,google-node-2048
google,node,2048,europe-west1,1977,1626,351,google-node-2048
google,node,2048,europe-west1,1617,1497,120,google-node-2048
google,node,2048,europe-west1,2726,2549,177,google-node-2048
google,node,2048,europe-west1,2785,2608,177,google-node-2048
google,node,2048,europe-west1,2085,1933,152,google-node-2048
google,node,2048,europe-west1,1823,1620,203,google-node-2048
google,node,2048,europe-west1,1785,1673,112,google-node-2048
google,node,2048,europe-west1,1576,1513,63,google-node-2048
google,node,2048,europe-west1,1654,1583,71,google-node-2048
google,node,2048,europe-west1,1653,1563,90,google-node-2048
google,node,2048,europe-west1,1601,1526,75,google-node-2048
google,node,2048,europe-west1,1673,1592,81,google-node-2048
google,node,2048,europe-west1,1635,1502,133,google-node-2048
google,node,2048,europe-west1,1776,1659,117,google-node-2048
google,node,2048,europe-west1,1848,1660,188,google-node-2048
google,node,2048,europe-west1,1751,1636,115,google-node-2048
google,node,2048,europe-west1,1995,1873,122,google-node-2048
google,node,2048,europe-west1,1833,1705,128,google-node-2048
google,node,2048,europe-west1,1691,1560,131,google-node-2048
google,node,2048,europe-west1,1598,1485,113,google-node-2048
google,node,2048,europe-west1,1676,1556,120,google-node-2048
google,node,2048,europe-west1,1657,1532,125,google-node-2048
google,node,2048,europe-west1,1781,1660,121,google-node-2048
google,node,2048,europe-west1,1613,1494,119,google-node-2048
google,node,2048,europe-west1,1804,1411,393,google-node-2048
google,node,2048,europe-west1,1603,1498,105,google-node-2048
google,node,2048,europe-west1,1583,1508,75,google-node-2048
google,node,2048,europe-west1,1616,1505,111,google-node-2048
google,node,2048,europe-west1,1592,1421,171,google-node-2048
google,python,128,europe-west1,6650,6306,344,google-python-128
google,python,128,europe-west1,5848,1229,4619,google-python-128
google,python,128,europe-west1,6758,1872,4886,google-python-128
google,python,128,europe-west1,6585,1867,4718,google-python-128
google,python,128,europe-west1,8542,8399,143,google-python-128
google,python,128,europe-west1,8745,8502,243,google-python-128
google,python,128,europe-west1,8528,8306,222,google-python-128
google,python,128,europe-west1,8331,8192,139,google-python-128
google,python,128,europe-west1,7031,6799,232,google-python-128
google,python,128,europe-west1,8630,8486,144,google-python-128
google,python,128,europe-west1,9639,9511,128,google-python-128
google,python,128,europe-west1,9933,9694,239,google-python-128
google,python,128,europe-west1,10140,9995,145,google-python-128
google,python,128,europe-west1,9227,9109,118,google-python-128
google,python,128,europe-west1,8633,8408,225,google-python-128
google,python,128,europe-west1,9320,9093,227,google-python-128
google,python,128,europe-west1,8613,8502,111,google-python-128
google,python,128,europe-west1,8409,8284,125,google-python-128
google,python,128,europe-west1,7711,7498,213,google-python-128
google,python,128,europe-west1,6724,6504,220,google-python-128
google,python,128,europe-west1,7310,7192,118,google-python-128
google,python,128,europe-west1,7631,7498,133,google-python-128
google,python,128,europe-west1,7933,7787,146,google-python-128
google,python,128,europe-west1,7711,7500,211,google-python-128
google,python,128,europe-west1,7137,6997,140,google-python-128
google,python,128,europe-west1,7713,7589,124,google-python-128
google,python,128,europe-west1,7010,6706,304,google-python-128
google,python,128,europe-west1,7317,7074,243,google-python-128
google,python,128,europe-west1,6431,6311,120,google-python-128
google,python,128,europe-west1,8711,8502,209,google-python-128
google,python,128,europe-west1,8286,8097,189,google-python-128
google,python,128,europe-west1,6218,6092,126,google-python-128
google,python,128,europe-west1,7219,6907,312,google-python-128
google,python,128,europe-west1,8621,8499,122,google-python-128
google,python,128,europe-west1,8907,8700,207,google-python-128
google,python,128,europe-west1,8107,7759,348,google-python-128
google,python,128,europe-west1,9190,8987,203,google-python-128
google,python,128,europe-west1,9248,8601,647,google-python-128
google,python,128,europe-west1,6496,6265,231,google-python-128
google,python,128,europe-west1,8008,7713,295,google-python-128
google,python,128,europe-west1,7910,7695,215,google-python-128
google,python,128,europe-west1,7680,7457,223,google-python-128
google,python,128,europe-west1,8883,8691,192,google-python-128
google,python,128,europe-west1,10475,10354,121,google-python-128
google,python,128,europe-west1,9081,8951,130,google-python-128
google,python,128,europe-west1,6495,6304,191,google-python-128
google,python,128,europe-west1,6588,6306,282,google-python-128
google,python,128,europe-west1,7280,7159,121,google-python-128
google,python,128,europe-west1,6686,6490,196,google-python-128
google,python,128,europe-west1,7569,7397,172,google-python-128
google,python,128,europe-west1,6680,6407,273,google-python-128
google,python,128,europe-west1,9062,8803,259,google-python-128
google,python,128,europe-west1,11963,11697,266,google-python-128
google,python,128,europe-west1,11190,10952,238,google-python-128
google,python,128,europe-west1,10577,8588,1989,google-python-128
google,python,128,europe-west1,6585,6307,278,google-python-128
google,python,128,europe-west1,7463,7338,125,google-python-128
google,python,128,europe-west1,7287,7103,184,google-python-128
google,python,128,europe-west1,7371,7193,178,google-python-128
google,python,128,europe-west1,7152,7039,113,google-python-128
google,python,128,europe-west1,7367,7240,127,google-python-128
google,python,128,europe-west1,8347,8238,109,google-python-128
google,python,128,europe-west1,8141,7909,232,google-python-128
google,python,128,europe-west1,7349,7204,145,google-python-128
google,python,128,europe-west1,7223,7094,129,google-python-128
google,python,128,europe-west1,6555,6411,144,google-python-128
google,python,128,europe-west1,8042,7914,128,google-python-128
google,python,128,europe-west1,8928,8798,130,google-python-128
google,python,128,europe-west1,7826,7562,264,google-python-128
google,python,128,europe-west1,6545,6427,118,google-python-128
google,python,128,europe-west1,8230,7977,253,google-python-128
google,python,128,europe-west1,9217,9004,213,google-python-128
google,python,128,europe-west1,8222,8104,118,google-python-128
google,python,128,europe-west1,9024,8898,126,google-python-128
google,python,128,europe-west1,9720,9501,219,google-python-128
google,python,128,europe-west1,9013,8878,135,google-python-128
google,python,128,europe-west1,8213,7909,304,google-python-128
google,python,128,europe-west1,8125,7990,135,google-python-128
google,python,128,europe-west1,9125,8581,544,google-python-128
google,python,128,europe-west1,9220,8994,226,google-python-128
google,python,128,europe-west1,8599,8398,201,google-python-128
google,python,128,europe-west1,6435,6221,214,google-python-128
google,python,128,europe-west1,7414,7294,120,google-python-128
google,python,128,europe-west1,6719,6597,122,google-python-128
google,python,128,europe-west1,8699,8410,289,google-python-128
google,python,128,europe-west1,8606,8479,127,google-python-128
google,python,128,europe-west1,7209,7009,200,google-python-128
google,python,128,europe-west1,7614,7492,122,google-python-128
google,python,128,europe-west1,7388,7188,200,google-python-128
google,python,128,europe-west1,7414,7097,317,google-python-128
google,python,128,europe-west1,7195,6998,197,google-python-128
google,python,128,europe-west1,7118,6902,216,google-python-128
google,python,128,europe-west1,7429,7217,212,google-python-128
google,python,128,europe-west1,8015,7810,205,google-python-128
google,python,128,europe-west1,7022,6897,125,google-python-128
google,python,128,europe-west1,7795,7602,193,google-python-128
google,python,128,europe-west1,9300,9179,121,google-python-128
google,python,128,europe-west1,9089,8890,199,google-python-128
google,python,128,europe-west1,7354,7214,140,google-python-128
google,python,128,europe-west1,6502,6212,290,google-python-128
google,python,256,europe-west1,3295,3178,117,google-python-256
google,python,256,europe-west1,3177,3008,169,google-python-256
google,python,256,europe-west1,4176,2893,1283,google-python-256
google,python,256,europe-west1,3160,3053,107,google-python-256
google,python,256,europe-west1,3265,3147,118,google-python-256
google,python,256,europe-west1,3162,3048,114,google-python-256
google,python,256,europe-west1,3158,3034,124,google-python-256
google,python,256,europe-west1,3155,2996,159,google-python-256
google,python,256,europe-west1,3063,2949,114,google-python-256
google,python,256,europe-west1,3265,3160,105,google-python-256
google,python,256,europe-west1,3252,3107,145,google-python-256
google,python,256,europe-west1,3696,3129,567,google-python-256
google,python,256,europe-west1,3262,3151,111,google-python-256
google,python,256,europe-west1,3449,3344,105,google-python-256
google,python,256,europe-west1,3370,3210,160,google-python-256
google,python,256,europe-west1,3449,3224,225,google-python-256
google,python,256,europe-west1,3635,3190,445,google-python-256
google,python,256,europe-west1,3733,3206,527,google-python-256
google,python,256,europe-west1,3039,2929,110,google-python-256
google,python,256,europe-west1,3350,3198,152,google-python-256
google,python,256,europe-west1,3324,3104,220,google-python-256
google,python,256,europe-west1,3236,3119,117,google-python-256
google,python,256,europe-west1,3546,3110,436,google-python-256
google,python,256,europe-west1,3218,3103,115,google-python-256
google,python,256,europe-west1,3345,3245,100,google-python-256
google,python,256,europe-west1,3228,3118,110,google-python-256
google,python,256,europe-west1,3418,3306,112,google-python-256
google,python,256,europe-west1,3210,3094,116,google-python-256
google,python,256,europe-west1,3223,3107,116,google-python-256
google,python,256,europe-west1,3216,3110,106,google-python-256
google,python,256,europe-west1,3204,3094,110,google-python-256
google,python,256,europe-west1,3120,3007,113,google-python-256
google,python,256,europe-west1,3427,3221,206,google-python-256
google,python,256,europe-west1,3333,3126,207,google-python-256
google,python,256,europe-west1,3404,3204,200,google-python-256
google,python,256,europe-west1,3575,3087,488,google-python-256
google,python,256,europe-west1,3293,3098,195,google-python-256
google,python,256,europe-west1,3325,3216,109,google-python-256
google,python,256,europe-west1,3309,3109,200,google-python-256
google,python,256,europe-west1,3310,3103,207,google-python-256
google,python,256,europe-west1,3313,3114,199,google-python-256
google,python,256,europe-west1,3383,3273,110,google-python-256
google,python,256,europe-west1,3388,3202,186,google-python-256
google,python,256,europe-west1,3093,2966,127,google-python-256
google,python,256,europe-west1,3479,3305,174,google-python-256
google,python,256,europe-west1,3929,3307,622,google-python-256
google,python,256,europe-west1,3048,2941,107,google-python-256
google,python,256,europe-west1,3248,3127,121,google-python-256
google,python,256,europe-west1,3063,2962,101,google-python-256
google,python,256,europe-west1,3067,2966,101,google-python-256
google,python,256,europe-west1,3153,3050,103,google-python-256
google,python,256,europe-west1,3259,3109,150,google-python-256
google,python,256,europe-west1,3249,3123,126,google-python-256
google,python,256,europe-west1,3150,3049,101,google-python-256
google,python,256,europe-west1,3357,3245,112,google-python-256
google,python,256,europe-west1,3048,2947,101,google-python-256
google,python,256,europe-west1,3158,3048,110,google-python-256
google,python,256,europe-west1,3156,3019,137,google-python-256
google,python,256,europe-west1,3143,2952,191,google-python-256
google,python,256,europe-west1,3143,3043,100,google-python-256
google,python,256,europe-west1,3238,3031,207,google-python-256
google,python,256,europe-west1,3460,3150,310,google-python-256
google,python,256,europe-west1,3265,3108,157,google-python-256
google,python,256,europe-west1,3327,3110,217,google-python-256
google,python,256,europe-west1,3234,3093,141,google-python-256
google,python,256,europe-west1,3155,3045,110,google-python-256
google,python,256,europe-west1,3347,3206,141,google-python-256
google,python,256,europe-west1,3341,3198,143,google-python-256
google,python,256,europe-west1,3231,3115,116,google-python-256
google,python,256,europe-west1,3229,3124,105,google-python-256
google,python,256,europe-west1,3233,3111,122,google-python-256
google,python,256,europe-west1,3230,3111,119,google-python-256
google,python,256,europe-west1,3228,3114,114,google-python-256
google,python,256,europe-west1,3515,3300,215,google-python-256
google,python,256,europe-west1,3240,3128,112,google-python-256
google,python,256,europe-west1,3128,3023,105,google-python-256
google,python,256,europe-west1,3227,3118,109,google-python-256
google,python,256,europe-west1,3132,3031,101,google-python-256
google,python,256,europe-west1,3236,3107,129,google-python-256
google,python,256,europe-west1,3324,3214,110,google-python-256
google,python,256,europe-west1,3220,3103,117,google-python-256
google,python,256,europe-west1,3307,3192,115,google-python-256
google,python,256,europe-west1,3472,3311,161,google-python-256
google,python,256,europe-west1,3464,3296,168,google-python-256
google,python,256,europe-west1,3178,3064,114,google-python-256
google,python,256,europe-west1,3168,3071,97,google-python-256
google,python,256,europe-west1,3041,2933,108,google-python-256
google,python,256,europe-west1,3323,3212,111,google-python-256
google,python,256,europe-west1,3322,3201,121,google-python-256
google,python,256,europe-west1,3245,3138,107,google-python-256
google,python,256,europe-west1,3311,3196,115,google-python-256
google,python,256,europe-west1,3320,3105,215,google-python-256
google,python,256,europe-west1,3426,3192,234,google-python-256
google,python,256,europe-west1,3425,3207,218,google-python-256
google,python,256,europe-west1,3225,3115,110,google-python-256
google,python,256,europe-west1,3329,3112,217,google-python-256
google,python,256,europe-west1,3208,3098,110,google-python-256
google,python,256,europe-west1,3308,3202,106,google-python-256
google,python,256,europe-west1,3199,2907,292,google-python-256
google,python,256,europe-west1,3407,3208,199,google-python-256
google,python,512,europe-west1,1548,1417,131,google-python-512
google,python,512,europe-west1,1750,1627,123,google-python-512
google,python,512,europe-west1,1569,1435,134,google-python-512
google,python,512,europe-west1,1544,1418,126,google-python-512
google,python,512,europe-west1,1632,1511,121,google-python-512
google,python,512,europe-west1,1479,1409,70,google-python-512
google,python,512,europe-west1,1453,1391,62,google-python-512
google,python,512,europe-west1,1564,1444,120,google-python-512
google,python,512,europe-west1,1467,1404,63,google-python-512
google,python,512,europe-west1,1695,1538,157,google-python-512
google,python,512,europe-west1,1635,1505,130,google-python-512
google,python,512,europe-west1,1481,1418,63,google-python-512
google,python,512,europe-west1,1585,1460,125,google-python-512
google,python,512,europe-west1,1656,1526,130,google-python-512
google,python,512,europe-west1,1628,1424,204,google-python-512
google,python,512,europe-west1,1658,1534,124,google-python-512
google,python,512,europe-west1,1650,1523,127,google-python-512
google,python,512,europe-west1,1645,1532,113,google-python-512
google,python,512,europe-west1,1470,1389,81,google-python-512
google,python,512,europe-west1,1637,1449,188,google-python-512
google,python,512,europe-west1,1524,1447,77,google-python-512
google,python,512,europe-west1,1579,1512,67,google-python-512
google,python,512,europe-west1,1690,1544,146,google-python-512
google,python,512,europe-west1,1827,1629,198,google-python-512
google,python,512,europe-west1,1419,1318,101,google-python-512
google,python,512,europe-west1,1650,1511,139,google-python-512
google,python,512,europe-west1,1672,1525,147,google-python-512
google,python,512,europe-west1,1582,1443,139,google-python-512
google,python,512,europe-west1,1487,1427,60,google-python-512
google,python,512,europe-west1,1687,1582,105,google-python-512
google,python,512,europe-west1,1359,1285,74,google-python-512
google,python,512,europe-west1,1748,1610,138,google-python-512
google,python,512,europe-west1,1718,1526,192,google-python-512
google,python,512,europe-west1,1689,1490,199,google-python-512
google,python,512,europe-west1,1686,1542,144,google-python-512
google,python,512,europe-west1,1471,1413,58,google-python-512
google,python,512,europe-west1,1643,1503,140,google-python-512
google,python,512,europe-west1,1798,1620,178,google-python-512
google,python,512,europe-west1,1540,1471,69,google-python-512
google,python,512,europe-west1,1724,1592,132,google-python-512
google,python,512,europe-west1,1447,1383,64,google-python-512
google,python,512,europe-west1,1571,1463,108,google-python-512
google,python,512,europe-west1,1615,1481,134,google-python-512
google,python,512,europe-west1,1543,1479,64,google-python-512
google,python,512,europe-west1,1417,1351,66,google-python-512
google,python,512,europe-west1,1461,1398,63,google-python-512
google,python,512,europe-west1,1646,1534,112,google-python-512
google,python,512,europe-west1,1687,1527,160,google-python-512
google,python,512,europe-west1,1541,1485,56,google-python-512
google,python,512,europe-west1,1539,1430,109,google-python-512
google,python,512,europe-west1,1630,1557,73,google-python-512
google,python,512,europe-west1,1641,1528,113,google-python-512
google,python,512,europe-west1,1567,1455,112,google-python-512
google,python,512,europe-west1,1731,1521,210,google-python-512
google,python,512,europe-west1,1626,1556,70,google-python-512
google,python,512,europe-west1,1619,1515,104,google-python-512
google,python,512,europe-west1,1589,1433,156,google-python-512
google,python,512,europe-west1,1351,1286,65,google-python-512
google,python,512,europe-west1,1539,1427,112,google-python-512
google,python,512,europe-west1,1407,1329,78,google-python-512
google,python,512,europe-west1,1627,1551,76,google-python-512
google,python,512,europe-west1,1860,1712,148,google-python-512
google,python,512,europe-west1,1747,1626,121,google-python-512
google,python,512,europe-west1,1846,1726,120,google-python-512
google,python,512,europe-west1,1587,1467,120,google-python-512
google,python,512,europe-west1,1711,1611,100,google-python-512
google,python,512,europe-west1,1683,1529,154,google-python-512
google,python,512,europe-west1,1588,1489,99,google-python-512
google,python,512,europe-west1,1532,1474,58,google-python-512
google,python,512,europe-west1,2014,1626,388,google-python-512
google,python,512,europe-west1,1600,1535,65,google-python-512
google,python,512,europe-west1,1605,1535,70,google-python-512
google,python,512,europe-west1,1961,1540,421,google-python-512
google,python,512,europe-west1,1722,1610,112,google-python-512
google,python,512,europe-west1,1698,1626,72,google-python-512
google,python,512,europe-west1,1608,1551,57,google-python-512
google,python,512,europe-west1,1827,1625,202,google-python-512
google,python,512,europe-west1,1671,1593,78,google-python-512
google,python,512,europe-west1,2082,1591,491,google-python-512
google,python,512,europe-west1,1689,1621,68,google-python-512
google,python,512,europe-west1,1645,1436,209,google-python-512
google,python,512,europe-west1,1603,1540,63,google-python-512
google,python,512,europe-west1,1705,1545,160,google-python-512
google,python,512,europe-west1,1730,1514,216,google-python-512
google,python,512,europe-west1,1751,1544,207,google-python-512
google,python,512,europe-west1,1650,1492,158,google-python-512
google,python,512,europe-west1,1672,1603,69,google-python-512
google,python,512,europe-west1,1600,1530,70,google-python-512
google,python,512,europe-west1,1917,1709,208,google-python-512
google,python,512,europe-west1,1643,1526,117,google-python-512
google,python,512,europe-west1,1547,1476,71,google-python-512
google,python,512,europe-west1,1582,1432,150,google-python-512
google,python,512,europe-west1,1869,1692,177,google-python-512
google,python,512,europe-west1,1552,1489,63,google-python-512
google,python,512,europe-west1,1663,1532,131,google-python-512
google,python,512,europe-west1,1560,1433,127,google-python-512
google,python,512,europe-west1,1470,1335,135,google-python-512
google,python,512,europe-west1,1521,1396,125,google-python-512
google,python,512,europe-west1,1635,1510,125,google-python-512
google,python,512,europe-west1,1460,1334,126,google-python-512
google,python,1024,europe-west1,1246,845,401,google-python-1024
google,python,1024,europe-west1,929,834,95,google-python-1024
google,python,1024,europe-west1,955,861,94,google-python-1024
google,python,1024,europe-west1,942,846,96,google-python-1024
google,python,1024,europe-west1,985,885,100,google-python-1024
google,python,1024,europe-west1,903,816,87,google-python-1024
google,python,1024,europe-west1,863,778,85,google-python-1024
google,python,1024,europe-west1,933,851,82,google-python-1024
google,python,1024,europe-west1,1009,922,87,google-python-1024
google,python,1024,europe-west1,893,811,82,google-python-1024
google,python,1024,europe-west1,909,828,81,google-python-1024
google,python,1024,europe-west1,945,865,80,google-python-1024
google,python,1024,europe-west1,982,910,72,google-python-1024
google,python,1024,europe-west1,994,921,73,google-python-1024
google,python,1024,europe-west1,1045,864,181,google-python-1024
google,python,1024,europe-west1,914,845,69,google-python-1024
google,python,1024,europe-west1,1040,872,168,google-python-1024
google,python,1024,europe-west1,1229,1145,84,google-python-1024
google,python,1024,europe-west1,893,832,61,google-python-1024
google,python,1024,europe-west1,1116,963,153,google-python-1024
google,python,1024,europe-west1,933,778,155,google-python-1024
google,python,1024,europe-west1,2689,746,1943,google-python-1024
google,python,1024,europe-west1,921,766,155,google-python-1024
google,python,1024,europe-west1,917,857,60,google-python-1024
google,python,1024,europe-west1,975,822,153,google-python-1024
google,python,1024,europe-west1,1042,900,142,google-python-1024
google,python,1024,europe-west1,1011,861,150,google-python-1024
google,python,1024,europe-west1,969,823,146,google-python-1024
google,python,1024,europe-west1,1367,1155,212,google-python-1024
google,python,1024,europe-west1,1426,1307,119,google-python-1024
google,python,1024,europe-west1,904,751,153,google-python-1024
google,python,1024,europe-west1,904,847,57,google-python-1024
google,python,1024,europe-west1,914,770,144,google-python-1024
google,python,1024,europe-west1,1059,910,149,google-python-1024
google,python,1024,europe-west1,954,816,138,google-python-1024
google,python,1024,europe-west1,885,751,134,google-python-1024
google,python,1024,europe-west1,1040,906,134,google-python-1024
google,python,1024,europe-west1,962,834,128,google-python-1024
google,python,1024,europe-west1,937,878,59,google-python-1024
google,python,1024,europe-west1,998,873,125,google-python-1024
google,python,1024,europe-west1,987,855,132,google-python-1024
google,python,1024,europe-west1,971,902,69,google-python-1024
google,python,1024,europe-west1,986,867,119,google-python-1024
google,python,1024,europe-west1,1293,1175,118,google-python-1024
google,python,1024,europe-west1,947,872,75,google-python-1024
google,python,1024,europe-west1,882,807,75,google-python-1024
google,python,1024,europe-west1,887,814,73,google-python-1024
google,python,1024,europe-west1,996,872,124,google-python-1024
google,python,1024,europe-west1,1013,900,113,google-python-1024
google,python,1024,europe-west1,868,754,114,google-python-1024
google,python,1024,europe-west1,1147,862,285,google-python-1024
google,python,1024,europe-west1,1035,921,114,google-python-1024
google,python,1024,europe-west1,1106,822,284,google-python-1024
google,python,1024,europe-west1,843,770,73,google-python-1024
google,python,1024,europe-west1,950,842,108,google-python-1024
google,python,1024,europe-west1,1019,862,157,google-python-1024
google,python,1024,europe-west1,940,882,58,google-python-1024
google,python,1024,europe-west1,1056,945,111,google-python-1024
google,python,1024,europe-west1,1015,908,107,google-python-1024
google,python,1024,europe-west1,972,870,102,google-python-1024
google,python,1024,europe-west1,867,787,80,google-python-1024
google,python,1024,europe-west1,1025,923,102,google-python-1024
google,python,1024,europe-west1,1028,909,119,google-python-1024
google,python,1024,europe-west1,982,859,123,google-python-1024
google,python,1024,europe-west1,981,865,116,google-python-1024
google,python,1024,europe-west1,852,789,63,google-python-1024
google,python,1024,europe-west1,862,806,56,google-python-1024
google,python,1024,europe-west1,917,849,68,google-python-1024
google,python,1024,europe-west1,869,794,75,google-python-1024
google,python,1024,europe-west1,972,906,66,google-python-1024
google,python,1024,europe-west1,905,834,71,google-python-1024
google,python,1024,europe-west1,1114,1006,108,google-python-1024
google,python,1024,europe-west1,973,866,107,google-python-1024
google,python,1024,europe-west1,977,869,108,google-python-1024
google,python,1024,europe-west1,953,892,61,google-python-1024
google,python,1024,europe-west1,1031,933,98,google-python-1024
google,python,1024,europe-west1,799,743,56,google-python-1024
google,python,1024,europe-west1,939,870,69,google-python-1024
google,python,1024,europe-west1,924,826,98,google-python-1024
google,python,1024,europe-west1,1058,987,71,google-python-1024
google,python,1024,europe-west1,1111,1000,111,google-python-1024
google,python,1024,europe-west1,1135,1060,75,google-python-1024
google,python,1024,europe-west1,909,842,67,google-python-1024
google,python,1024,europe-west1,1042,977,65,google-python-1024
google,python,1024,europe-west1,1060,966,94,google-python-1024
google,python,1024,europe-west1,954,884,70,google-python-1024
google,python,1024,europe-west1,908,811,97,google-python-1024
google,python,1024,europe-west1,964,872,92,google-python-1024
google,python,1024,europe-west1,917,836,81,google-python-1024
google,python,1024,europe-west1,897,809,88,google-python-1024
google,python,1024,europe-west1,962,868,94,google-python-1024
google,python,1024,europe-west1,936,866,70,google-python-1024
google,python,1024,europe-west1,891,824,67,google-python-1024
google,python,1024,europe-west1,999,899,100,google-python-1024
google,python,1024,europe-west1,992,920,72,google-python-1024
google,python,1024,europe-west1,892,806,86,google-python-1024
google,python,1024,europe-west1,967,881,86,google-python-1024
google,python,1024,europe-west1,932,867,65,google-python-1024
google,python,1024,europe-west1,963,895,68,google-python-1024
google,python,1024,europe-west1,894,834,60,google-python-1024
google,python,2048,europe-west1,773,697,76,google-python-2048
google,python,2048,europe-west1,888,804,84,google-python-2048
google,python,2048,europe-west1,707,637,70,google-python-2048
google,python,2048,europe-west1,773,626,147,google-python-2048
google,python,2048,europe-west1,931,790,141,google-python-2048
google,python,2048,europe-west1,729,663,66,google-python-2048
google,python,2048,europe-west1,768,702,66,google-python-2048
google,python,2048,europe-west1,680,598,82,google-python-2048
google,python,2048,europe-west1,810,679,131,google-python-2048
google,python,2048,europe-west1,685,631,54,google-python-2048
google,python,2048,europe-west1,802,672,130,google-python-2048
google,python,2048,europe-west1,724,645,79,google-python-2048
google,python,2048,europe-west1,845,776,69,google-python-2048
google,python,2048,europe-west1,1064,933,131,google-python-2048
google,python,2048,europe-west1,607,534,73,google-python-2048
google,python,2048,europe-west1,854,732,122,google-python-2048
google,python,2048,europe-west1,777,653,124,google-python-2048
google,python,2048,europe-west1,674,613,61,google-python-2048
google,python,2048,europe-west1,744,677,67,google-python-2048
google,python,2048,europe-west1,775,645,130,google-python-2048
google,python,2048,europe-west1,708,626,82,google-python-2048
google,python,2048,europe-west1,1023,898,125,google-python-2048
google,python,2048,europe-west1,941,877,64,google-python-2048
google,python,2048,europe-west1,716,600,116,google-python-2048
google,python,2048,europe-west1,937,817,120,google-python-2048
google,python,2048,europe-west1,746,676,70,google-python-2048
google,python,2048,europe-west1,787,675,112,google-python-2048
google,python,2048,europe-west1,750,645,105,google-python-2048
google,python,2048,europe-west1,822,719,103,google-python-2048
google,python,2048,europe-west1,788,719,69,google-python-2048
google,python,2048,europe-west1,727,629,98,google-python-2048
google,python,2048,europe-west1,771,676,95,google-python-2048
google,python,2048,europe-west1,778,688,90,google-python-2048
google,python,2048,europe-west1,857,766,91,google-python-2048
google,python,2048,europe-west1,712,631,81,google-python-2048
google,python,2048,europe-west1,748,688,60,google-python-2048
google,python,2048,europe-west1,768,684,84,google-python-2048
google,python,2048,europe-west1,1105,1014,91,google-python-2048
google,python,2048,europe-west1,909,827,82,google-python-2048
google,python,2048,europe-west1,1027,931,96,google-python-2048
google,python,2048,europe-west1,1233,1153,80,google-python-2048
google,python,2048,europe-west1,878,791,87,google-python-2048
google,python,2048,europe-west1,788,720,68,google-python-2048
google,python,2048,europe-west1,782,704,78,google-python-2048
google,python,2048,europe-west1,743,681,62,google-python-2048
google,python,2048,europe-west1,755,669,86,google-python-2048
google,python,2048,europe-west1,837,774,63,google-python-2048
google,python,2048,europe-west1,837,671,166,google-python-2048
google,python,2048,europe-west1,747,689,58,google-python-2048
google,python,2048,europe-west1,955,889,66,google-python-2048
google,python,2048,europe-west1,980,821,159,google-python-2048
google,python,2048,europe-west1,684,624,60,google-python-2048
google,python,2048,europe-west1,745,683,62,google-python-2048
google,python,2048,europe-west1,726,654,72,google-python-2048
google,python,2048,europe-west1,879,735,144,google-python-2048
google,python,2048,europe-west1,681,619,62,google-python-2048
google,python,2048,europe-west1,897,760,137,google-python-2048
google,python,2048,europe-west1,775,716,59,google-python-2048
google,python,2048,europe-west1,846,768,78,google-python-2048
google,python,2048,europe-west1,1135,1054,81,google-python-2048
google,python,2048,europe-west1,1029,897,132,google-python-2048
google,python,2048,europe-west1,3976,1332,2644,google-python-2048
google,python,2048,europe-west1,965,890,75,google-python-2048
google,python,2048,europe-west1,959,848,111,google-python-2048
google,python,2048,europe-west1,802,736,66,google-python-2048
google,python,2048,europe-west1,916,829,87,google-python-2048
google,python,2048,europe-west1,912,828,84,google-python-2048
google,python,2048,europe-west1,1137,1064,73,google-python-2048
google,python,2048,europe-west1,935,850,85,google-python-2048
google,python,2048,europe-west1,1025,925,100,google-python-2048
google,python,2048,europe-west1,1045,962,83,google-python-2048
google,python,2048,europe-west1,1267,1166,101,google-python-2048
google,python,2048,europe-west1,1344,1275,69,google-python-2048
google,python,2048,europe-west1,1240,1152,88,google-python-2048
google,python,2048,europe-west1,1006,935,71,google-python-2048
google,python,2048,europe-west1,892,812,80,google-python-2048
google,python,2048,europe-west1,829,711,118,google-python-2048
google,python,2048,europe-west1,849,756,93,google-python-2048
google,python,2048,europe-west1,754,658,96,google-python-2048
google,python,2048,europe-west1,764,694,70,google-python-2048
google,python,2048,europe-west1,929,828,101,google-python-2048
google,python,2048,europe-west1,778,682,96,google-python-2048
google,python,2048,europe-west1,726,633,93,google-python-2048
google,python,2048,europe-west1,770,683,87,google-python-2048
google,python,2048,europe-west1,703,613,90,google-python-2048
google,python,2048,europe-west1,823,764,59,google-python-2048
google,python,2048,europe-west1,823,741,82,google-python-2048
google,python,2048,europe-west1,781,694,87,google-python-2048
google,python,2048,europe-west1,782,706,76,google-python-2048
google,python,2048,europe-west1,794,716,78,google-python-2048
google,python,2048,europe-west1,922,854,68,google-python-2048
google,python,2048,europe-west1,711,640,71,google-python-2048
google,python,2048,europe-west1,749,687,62,google-python-2048
google,python,2048,europe-west1,813,729,84,google-python-2048
google,python,2048,europe-west1,696,641,55,google-python-2048
google,python,2048,europe-west1,801,664,137,google-python-2048
google,python,2048,europe-west1,742,674,68,google-python-2048
google,python,2048,europe-west1,839,680,159,google-python-2048
google,python,2048,europe-west1,731,667,64,google-python-2048
google,python,2048,europe-west1,1524,1382,142,google-python-2048
