cloud,runtime,memory_mb,region,total_ms,measured_ms,latency_ms,name
aws,dotnet,128,eu-central-1,885,716,169,aws-dotnet-128
aws,dotnet,128,eu-central-1,765,670,95,aws-dotnet-128
aws,dotnet,128,eu-central-1,746,663,83,aws-dotnet-128
aws,dotnet,128,eu-central-1,745,663,82,aws-dotnet-128
aws,dotnet,128,eu-central-1,801,702,99,aws-dotnet-128
aws,dotnet,128,eu-central-1,763,682,81,aws-dotnet-128
aws,dotnet,128,eu-central-1,835,683,152,aws-dotnet-128
aws,dotnet,128,eu-central-1,736,662,74,aws-dotnet-128
aws,dotnet,128,eu-central-1,773,684,89,aws-dotnet-128
aws,dotnet,128,eu-central-1,769,679,90,aws-dotnet-128
aws,dotnet,128,eu-central-1,754,687,67,aws-dotnet-128
aws,dotnet,128,eu-central-1,741,663,78,aws-dotnet-128
aws,dotnet,128,eu-central-1,768,705,63,aws-dotnet-128
aws,dotnet,128,eu-central-1,781,642,139,aws-dotnet-128
aws,dotnet,128,eu-central-1,747,654,93,aws-dotnet-128
aws,dotnet,128,eu-central-1,724,646,78,aws-dotnet-128
aws,dotnet,128,eu-central-1,721,643,78,aws-dotnet-128
aws,dotnet,128,eu-central-1,756,666,90,aws-dotnet-128
aws,dotnet,128,eu-central-1,759,671,88,aws-dotnet-128
aws,dotnet,128,eu-central-1,748,675,73,aws-dotnet-128
aws,dotnet,128,eu-central-1,712,654,58,aws-dotnet-128
aws,dotnet,128,eu-central-1,752,698,54,aws-dotnet-128
aws,dotnet,128,eu-central-1,774,679,95,aws-dotnet-128
aws,dotnet,128,eu-central-1,764,678,86,aws-dotnet-128
aws,dotnet,128,eu-central-1,749,687,62,aws-dotnet-128
aws,dotnet,128,eu-central-1,786,691,95,aws-dotnet-128
aws,dotnet,128,eu-central-1,737,643,94,aws-dotnet-128
aws,dotnet,128,eu-central-1,722,646,76,aws-dotnet-128
aws,dotnet,128,eu-central-1,743,675,68,aws-dotnet-128
aws,dotnet,128,eu-central-1,725,647,78,aws-dotnet-128
aws,dotnet,128,eu-central-1,710,642,68,aws-dotnet-128
aws,dotnet,128,eu-central-1,772,691,81,aws-dotnet-128
aws,dotnet,128,eu-central-1,763,674,89,aws-dotnet-128
aws,dotnet,128,eu-central-1,695,631,64,aws-dotnet-128
aws,dotnet,128,eu-central-1,729,647,82,aws-dotnet-128
aws,dotnet,128,eu-central-1,968,659,309,aws-dotnet-128
aws,dotnet,128,eu-central-1,748,670,78,aws-dotnet-128
aws,dotnet,128,eu-central-1,746,658,88,aws-dotnet-128
aws,dotnet,128,eu-central-1,747,651,96,aws-dotnet-128
aws,dotnet,128,eu-central-1,758,675,83,aws-dotnet-128
aws,dotnet,128,eu-central-1,725,666,59,aws-dotnet-128
aws,dotnet,128,eu-central-1,725,643,82,aws-dotnet-128
aws,dotnet,128,eu-central-1,757,699,58,aws-dotnet-128
aws,dotnet,128,eu-central-1,739,671,68,aws-dotnet-128
aws,dotnet,128,eu-central-1,738,658,80,aws-dotnet-128
aws,dotnet,128,eu-central-1,716,658,58,aws-dotnet-128
aws,dotnet,128,eu-central-1,733,667,66,aws-dotnet-128
aws,dotnet,128,eu-central-1,748,686,62,aws-dotnet-128
aws,dotnet,128,eu-central-1,748,666,82,aws-dotnet-128
aws,dotnet,128,eu-central-1,728,662,66,aws-dotnet-128
aws,dotnet,128,eu-central-1,766,666,100,aws-dotnet-128
aws,dotnet,128,eu-central-1,729,659,70,aws-dotnet-128
aws,dotnet,128,eu-central-1,785,684,101,aws-dotnet-128
aws,dotnet,128,eu-central-1,764,634,130,aws-dotnet-128
aws,dotnet,128,eu-central-1,746,674,72,aws-dotnet-128
aws,dotnet,128,eu-central-1,725,655,70,aws-dotnet-128
aws,dotnet,128,eu-central-1,719,659,60,aws-dotnet-128
aws,dotnet,128,eu-central-1,753,686,67,aws-dotnet-128
aws,dotnet,128,eu-central-1,716,643,73,aws-dotnet-128
aws,dotnet,128,eu-central-1,737,662,75,aws-dotnet-128
aws,dotnet,128,eu-central-1,1246,712,534,aws-dotnet-128
aws,dotnet,128,eu-central-1,772,688,84,aws-dotnet-128
aws,dotnet,128,eu-central-1,734,653,81,aws-dotnet-128
aws,dotnet,128,eu-central-1,724,654,70,aws-dotnet-128
aws,dotnet,128,eu-central-1,752,679,73,aws-dotnet-128
aws,dotnet,128,eu-central-1,766,698,68,aws-dotnet-128
aws,dotnet,128,eu-central-1,728,658,70,aws-dotnet-128
aws,dotnet,128,eu-central-1,770,698,72,aws-dotnet-128
aws,dotnet,128,eu-central-1,743,672,71,aws-dotnet-128
aws,dotnet,128,eu-central-1,726,661,65,aws-dotnet-128
aws,dotnet,128,eu-central-1,748,679,69,aws-dotnet-128
aws,dotnet,128,eu-central-1,743,678,65,aws-dotnet-128
aws,dotnet,128,eu-central-1,766,697,69,aws-dotnet-128
aws,dotnet,128,eu-central-1,755,679,76,aws-dotnet-128
aws,dotnet,128,eu-central-1,760,674,86,aws-dotnet-128
aws,dotnet,128,eu-central-1,721,643,78,aws-dotnet-128
aws,dotnet,128,eu-central-1,743,681,62,aws-dotnet-128
aws,dotnet,128,eu-central-1,736,658,78,aws-dotnet-128
aws,dotnet,128,eu-central-1,756,660,96,aws-dotnet-128
aws,dotnet,128,eu-central-1,719,646,73,aws-dotnet-128
aws,dotnet,128,eu-central-1,1090,667,423,aws-dotnet-128
aws,dotnet,128,eu-central-1,849,678,171,aws-dotnet-128
aws,dotnet,128,eu-central-1,730,666,64,aws-dotnet-128
aws,dotnet,128,eu-central-1,742,670,72,aws-dotnet-128
aws,dotnet,128,eu-central-1,740,679,61,aws-dotnet-128
aws,dotnet,128,eu-central-1,738,666,72,aws-dotnet-128
aws,dotnet,128,eu-central-1,769,682,87,aws-dotnet-128
aws,dotnet,128,eu-central-1,759,663,96,aws-dotnet-128
aws,dotnet,128,eu-central-1,739,677,62,aws-dotnet-128
aws,dotnet,128,eu-central-1,755,662,93,aws-dotnet-128
aws,dotnet,128,eu-central-1,736,666,70,aws-dotnet-128
aws,dotnet,128,eu-central-1,740,655,85,aws-dotnet-128
aws,dotnet,128,eu-central-1,763,694,69,aws-dotnet-128
aws,dotnet,128,eu-central-1,720,662,58,aws-dotnet-128
aws,dotnet,128,eu-central-1,759,663,96,aws-dotnet-128
aws,dotnet,128,eu-central-1,742,663,79,aws-dotnet-128
aws,dotnet,128,eu-central-1,760,670,90,aws-dotnet-128
aws,dotnet,128,eu-central-1,778,649,129,aws-dotnet-128
aws,dotnet,128,eu-central-1,792,655,137,aws-dotnet-128
aws,dotnet,128,eu-central-1,733,657,76,aws-dotnet-128
aws,dotnet,256,eu-central-1,501,340,161,aws-dotnet-256
aws,dotnet,256,eu-central-1,413,339,74,aws-dotnet-256
aws,dotnet,256,eu-central-1,393,323,70,aws-dotnet-256
aws,dotnet,256,eu-central-1,407,335,72,aws-dotnet-256
aws,dotnet,256,eu-central-1,403,339,64,aws-dotnet-256
aws,dotnet,256,eu-central-1,401,326,75,aws-dotnet-256
aws,dotnet,256,eu-central-1,397,327,70,aws-dotnet-256
aws,dotnet,256,eu-central-1,436,343,93,aws-dotnet-256
aws,dotnet,256,eu-central-1,399,318,81,aws-dotnet-256
aws,dotnet,256,eu-central-1,397,326,71,aws-dotnet-256
aws,dotnet,256,eu-central-1,376,306,70,aws-dotnet-256
aws,dotnet,256,eu-central-1,395,319,76,aws-dotnet-256
aws,dotnet,256,eu-central-1,411,327,84,aws-dotnet-256
aws,dotnet,256,eu-central-1,413,328,85,aws-dotnet-256
aws,dotnet,256,eu-central-1,393,335,58,aws-dotnet-256
aws,dotnet,256,eu-central-1,391,323,68,aws-dotnet-256
aws,dotnet,256,eu-central-1,726,343,383,aws-dotnet-256
aws,dotnet,256,eu-central-1,750,346,404,aws-dotnet-256
aws,dotnet,256,eu-central-1,438,356,82,aws-dotnet-256
aws,dotnet,256,eu-central-1,412,336,76,aws-dotnet-256
aws,dotnet,256,eu-central-1,390,327,63,aws-dotnet-256
aws,dotnet,256,eu-central-1,407,327,80,aws-dotnet-256
aws,dotnet,256,eu-central-1,427,345,82,aws-dotnet-256
aws,dotnet,256,eu-central-1,397,323,74,aws-dotnet-256
aws,dotnet,256,eu-central-1,394,340,54,aws-dotnet-256
aws,dotnet,256,eu-central-1,436,338,98,aws-dotnet-256
aws,dotnet,256,eu-central-1,398,324,74,aws-dotnet-256
aws,dotnet,256,eu-central-1,417,331,86,aws-dotnet-256
aws,dotnet,256,eu-central-1,377,314,63,aws-dotnet-256
aws,dotnet,256,eu-central-1,396,327,69,aws-dotnet-256
aws,dotnet,256,eu-central-1,391,330,61,aws-dotnet-256
aws,dotnet,256,eu-central-1,411,339,72,aws-dotnet-256
aws,dotnet,256,eu-central-1,411,343,68,aws-dotnet-256
aws,dotnet,256,eu-central-1,405,315,90,aws-dotnet-256
aws,dotnet,256,eu-central-1,388,335,53,aws-dotnet-256
aws,dotnet,256,eu-central-1,364,307,57,aws-dotnet-256
aws,dotnet,256,eu-central-1,393,319,74,aws-dotnet-256
aws,dotnet,256,eu-central-1,403,324,79,aws-dotnet-256
aws,dotnet,256,eu-central-1,401,323,78,aws-dotnet-256
aws,dotnet,256,eu-central-1,400,323,77,aws-dotnet-256
aws,dotnet,256,eu-central-1,407,333,74,aws-dotnet-256
aws,dotnet,256,eu-central-1,386,331,55,aws-dotnet-256
aws,dotnet,256,eu-central-1,405,335,70,aws-dotnet-256
aws,dotnet,256,eu-central-1,387,312,75,aws-dotnet-256
aws,dotnet,256,eu-central-1,401,331,70,aws-dotnet-256
aws,dotnet,256,eu-central-1,399,335,64,aws-dotnet-256
aws,dotnet,256,eu-central-1,415,335,80,aws-dotnet-256
aws,dotnet,256,eu-central-1,399,315,84,aws-dotnet-256
aws,dotnet,256,eu-central-1,411,321,90,aws-dotnet-256
aws,dotnet,256,eu-central-1,414,327,87,aws-dotnet-256
aws,dotnet,256,eu-central-1,682,339,343,aws-dotnet-256
aws,dotnet,256,eu-central-1,409,338,71,aws-dotnet-256
aws,dotnet,256,eu-central-1,421,334,87,aws-dotnet-256
aws,dotnet,256,eu-central-1,389,327,62,aws-dotnet-256
aws,dotnet,256,eu-central-1,410,334,76,aws-dotnet-256
aws,dotnet,256,eu-central-1,369,310,59,aws-dotnet-256
aws,dotnet,256,eu-central-1,394,335,59,aws-dotnet-256
aws,dotnet,256,eu-central-1,389,331,58,aws-dotnet-256
aws,dotnet,256,eu-central-1,407,337,70,aws-dotnet-256
aws,dotnet,256,eu-central-1,392,336,56,aws-dotnet-256
aws,dotnet,256,eu-central-1,388,324,64,aws-dotnet-256
aws,dotnet,256,eu-central-1,410,335,75,aws-dotnet-256
aws,dotnet,256,eu-central-1,408,327,81,aws-dotnet-256
aws,dotnet,256,eu-central-1,417,353,64,aws-dotnet-256
aws,dotnet,256,eu-central-1,436,364,72,aws-dotnet-256
aws,dotnet,256,eu-central-1,420,339,81,aws-dotnet-256
aws,dotnet,256,eu-central-1,414,356,58,aws-dotnet-256
aws,dotnet,256,eu-central-1,433,359,74,aws-dotnet-256
aws,dotnet,256,eu-central-1,414,339,75,aws-dotnet-256
aws,dotnet,256,eu-central-1,394,327,67,aws-dotnet-256
aws,dotnet,256,eu-central-1,417,343,74,aws-dotnet-256
aws,dotnet,256,eu-central-1,391,319,72,aws-dotnet-256
aws,dotnet,256,eu-central-1,420,307,113,aws-dotnet-256
aws,dotnet,256,eu-central-1,396,323,73,aws-dotnet-256
aws,dotnet,256,eu-central-1,404,307,97,aws-dotnet-256
aws,dotnet,256,eu-central-1,379,327,52,aws-dotnet-256
aws,dotnet,256,eu-central-1,420,346,74,aws-dotnet-256
aws,dotnet,256,eu-central-1,380,316,64,aws-dotnet-256
aws,dotnet,256,eu-central-1,380,323,57,aws-dotnet-256
aws,dotnet,256,eu-central-1,377,323,54,aws-dotnet-256
aws,dotnet,256,eu-central-1,379,315,64,aws-dotnet-256
aws,dotnet,256,eu-central-1,397,331,66,aws-dotnet-256
aws,dotnet,256,eu-central-1,689,335,354,aws-dotnet-256
aws,dotnet,256,eu-central-1,388,335,53,aws-dotnet-256
aws,dotnet,256,eu-central-1,390,328,62,aws-dotnet-256
aws,dotnet,256,eu-central-1,406,323,83,aws-dotnet-256
aws,dotnet,256,eu-central-1,406,335,71,aws-dotnet-256
aws,dotnet,256,eu-central-1,386,327,59,aws-dotnet-256
aws,dotnet,256,eu-central-1,404,341,63,aws-dotnet-256
aws,dotnet,256,eu-central-1,388,327,61,aws-dotnet-256
aws,dotnet,256,eu-central-1,404,331,73,aws-dotnet-256
aws,dotnet,256,eu-central-1,397,315,82,aws-dotnet-256
aws,dotnet,256,eu-central-1,379,323,56,aws-dotnet-256
aws,dotnet,256,eu-central-1,418,335,83,aws-dotnet-256
aws,dotnet,256,eu-central-1,413,307,106,aws-dotnet-256
aws,dotnet,256,eu-central-1,420,332,88,aws-dotnet-256
aws,dotnet,256,eu-central-1,397,339,58,aws-dotnet-256
aws,dotnet,256,eu-central-1,411,331,80,aws-dotnet-256
aws,dotnet,256,eu-central-1,493,311,182,aws-dotnet-256
aws,dotnet,256,eu-central-1,380,327,53,aws-dotnet-256
aws,dotnet,512,eu-central-1,282,176,106,aws-dotnet-512
aws,dotnet,512,eu-central-1,247,167,80,aws-dotnet-512
aws,dotnet,512,eu-central-1,249,154,95,aws-dotnet-512
aws,dotnet,512,eu-central-1,228,151,77,aws-dotnet-512
aws,dotnet,512,eu-central-1,227,159,68,aws-dotnet-512
aws,dotnet,512,eu-central-1,222,151,71,aws-dotnet-512
aws,dotnet,512,eu-central-1,240,159,81,aws-dotnet-512
aws,dotnet,512,eu-central-1,222,158,64,aws-dotnet-512
aws,dotnet,512,eu-central-1,221,155,66,aws-dotnet-512
aws,dotnet,512,eu-central-1,241,167,74,aws-dotnet-512
aws,dotnet,512,eu-central-1,220,151,69,aws-dotnet-512
aws,dotnet,512,eu-central-1,233,151,82,aws-dotnet-512
aws,dotnet,512,eu-central-1,238,155,83,aws-dotnet-512
aws,dotnet,512,eu-central-1,238,154,84,aws-dotnet-512
aws,dotnet,512,eu-central-1,217,150,67,aws-dotnet-512
aws,dotnet,512,eu-central-1,239,167,72,aws-dotnet-512
aws,dotnet,512,eu-central-1,227,154,73,aws-dotnet-512
aws,dotnet,512,eu-central-1,229,155,74,aws-dotnet-512
aws,dotnet,512,eu-central-1,255,166,89,aws-dotnet-512
aws,dotnet,512,eu-central-1,231,159,72,aws-dotnet-512
aws,dotnet,512,eu-central-1,221,155,66,aws-dotnet-512
aws,dotnet,512,eu-central-1,225,159,66,aws-dotnet-512
aws,dotnet,512,eu-central-1,224,151,73,aws-dotnet-512
aws,dotnet,512,eu-central-1,242,163,79,aws-dotnet-512
aws,dotnet,512,eu-central-1,240,158,82,aws-dotnet-512
aws,dotnet,512,eu-central-1,242,147,95,aws-dotnet-512
aws,dotnet,512,eu-central-1,242,160,82,aws-dotnet-512
aws,dotnet,512,eu-central-1,237,155,82,aws-dotnet-512
aws,dotnet,512,eu-central-1,239,167,72,aws-dotnet-512
aws,dotnet,512,eu-central-1,232,157,75,aws-dotnet-512
aws,dotnet,512,eu-central-1,249,175,74,aws-dotnet-512
aws,dotnet,512,eu-central-1,234,163,71,aws-dotnet-512
aws,dotnet,512,eu-central-1,268,167,101,aws-dotnet-512
aws,dotnet,512,eu-central-1,253,169,84,aws-dotnet-512
aws,dotnet,512,eu-central-1,230,162,68,aws-dotnet-512
aws,dotnet,512,eu-central-1,228,166,62,aws-dotnet-512
aws,dotnet,512,eu-central-1,236,151,85,aws-dotnet-512
aws,dotnet,512,eu-central-1,250,155,95,aws-dotnet-512
aws,dotnet,512,eu-central-1,244,167,77,aws-dotnet-512
aws,dotnet,512,eu-central-1,249,166,83,aws-dotnet-512
aws,dotnet,512,eu-central-1,242,159,83,aws-dotnet-512
aws,dotnet,512,eu-central-1,224,163,61,aws-dotnet-512
aws,dotnet,512,eu-central-1,254,180,74,aws-dotnet-512
aws,dotnet,512,eu-central-1,237,168,69,aws-dotnet-512
aws,dotnet,512,eu-central-1,215,146,69,aws-dotnet-512
aws,dotnet,512,eu-central-1,237,166,71,aws-dotnet-512
aws,dotnet,512,eu-central-1,232,159,73,aws-dotnet-512
aws,dotnet,512,eu-central-1,723,158,565,aws-dotnet-512
aws,dotnet,512,eu-central-1,301,163,138,aws-dotnet-512
aws,dotnet,512,eu-central-1,255,167,88,aws-dotnet-512
aws,dotnet,512,eu-central-1,234,162,72,aws-dotnet-512
aws,dotnet,512,eu-central-1,232,163,69,aws-dotnet-512
aws,dotnet,512,eu-central-1,410,166,244,aws-dotnet-512
aws,dotnet,512,eu-central-1,229,155,74,aws-dotnet-512
aws,dotnet,512,eu-central-1,230,167,63,aws-dotnet-512
aws,dotnet,512,eu-central-1,228,159,69,aws-dotnet-512
aws,dotnet,512,eu-central-1,427,159,268,aws-dotnet-512
aws,dotnet,512,eu-central-1,213,154,59,aws-dotnet-512
aws,dotnet,512,eu-central-1,229,158,71,aws-dotnet-512
aws,dotnet,512,eu-central-1,243,163,80,aws-dotnet-512
aws,dotnet,512,eu-central-1,246,167,79,aws-dotnet-512
aws,dotnet,512,eu-central-1,231,147,84,aws-dotnet-512
aws,dotnet,512,eu-central-1,231,163,68,aws-dotnet-512
aws,dotnet,512,eu-central-1,212,147,65,aws-dotnet-512
aws,dotnet,512,eu-central-1,231,159,72,aws-dotnet-512
aws,dotnet,512,eu-central-1,222,162,60,aws-dotnet-512
aws,dotnet,512,eu-central-1,246,155,91,aws-dotnet-512
aws,dotnet,512,eu-central-1,230,163,67,aws-dotnet-512
aws,dotnet,512,eu-central-1,237,162,75,aws-dotnet-512
aws,dotnet,512,eu-central-1,232,155,77,aws-dotnet-512
aws,dotnet,512,eu-central-1,233,160,73,aws-dotnet-512
aws,dotnet,512,eu-central-1,232,164,68,aws-dotnet-512
aws,dotnet,512,eu-central-1,421,148,273,aws-dotnet-512
aws,dotnet,512,eu-central-1,270,163,107,aws-dotnet-512
aws,dotnet,512,eu-central-1,233,164,69,aws-dotnet-512
aws,dotnet,512,eu-central-1,224,159,65,aws-dotnet-512
aws,dotnet,512,eu-central-1,218,160,58,aws-dotnet-512
aws,dotnet,512,eu-central-1,220,154,66,aws-dotnet-512
aws,dotnet,512,eu-central-1,640,166,474,aws-dotnet-512
aws,dotnet,512,eu-central-1,242,163,79,aws-dotnet-512
aws,dotnet,512,eu-central-1,534,159,375,aws-dotnet-512
aws,dotnet,512,eu-central-1,214,159,55,aws-dotnet-512
aws,dotnet,512,eu-central-1,236,151,85,aws-dotnet-512
aws,dotnet,512,eu-central-1,236,155,81,aws-dotnet-512
aws,dotnet,512,eu-central-1,234,167,67,aws-dotnet-512
aws,dotnet,512,eu-central-1,234,154,80,aws-dotnet-512
aws,dotnet,512,eu-central-1,239,154,85,aws-dotnet-512
aws,dotnet,512,eu-central-1,233,159,74,aws-dotnet-512
aws,dotnet,512,eu-central-1,232,159,73,aws-dotnet-512
aws,dotnet,512,eu-central-1,235,159,76,aws-dotnet-512
aws,dotnet,512,eu-central-1,245,160,85,aws-dotnet-512
aws,dotnet,512,eu-central-1,229,159,70,aws-dotnet-512
aws,dotnet,512,eu-central-1,676,151,525,aws-dotnet-512
aws,dotnet,512,eu-central-1,233,163,70,aws-dotnet-512
aws,dotnet,512,eu-central-1,249,166,83,aws-dotnet-512
aws,dotnet,512,eu-central-1,227,160,67,aws-dotnet-512
aws,dotnet,512,eu-central-1,231,159,72,aws-dotnet-512
aws,dotnet,512,eu-central-1,244,154,90,aws-dotnet-512
aws,dotnet,512,eu-central-1,251,162,89,aws-dotnet-512
aws,dotnet,512,eu-central-1,224,155,69,aws-dotnet-512
aws,dotnet,1024,eu-central-1,459,79,380,aws-dotnet-1024
aws,dotnet,1024,eu-central-1,150,78,72,aws-dotnet-1024
aws,dotnet,1024,eu-central-1,145,86,59,aws-dotnet-1024
aws,dotnet,1024,eu-central-1,148,81,67,aws-dotnet-1024
aws,dotnet,1024,eu-central-1,144,86,58,aws-dotnet-1024
aws,dotnet,1024,eu-central-1,148,78,70,aws-dotnet-1024
aws,dotnet,1024,eu-central-1,157,86,71,aws-dotnet-1024
aws,dotnet,1024,eu-central-1,138,82,56,aws-dotnet-1024
aws,dotnet,1024,eu-central-1,140,86,54,aws-dotnet-1024
aws,dotnet,1024,eu-central-1,156,78,78,aws-dotnet-1024
aws,dotnet,1024,eu-central-1,156,78,78,aws-dotnet-1024
aws,dotnet,1024,eu-central-1,136,74,62,aws-dotnet-1024
aws,dotnet,1024,eu-central-1,147,82,65,aws-dotnet-1024
aws,dotnet,1024,eu-central-1,210,83,127,aws-dotnet-1024
aws,dotnet,1024,eu-central-1,158,78,80,aws-dotnet-1024
aws,dotnet,1024,eu-central-1,147,83,64,aws-dotnet-1024
aws,dotnet,1024,eu-central-1,158,87,71,aws-dotnet-1024
aws,dotnet,1024,eu-central-1,165,74,91,aws-dotnet-1024
aws,dotnet,1024,eu-central-1,129,74,55,aws-dotnet-1024
aws,dotnet,1024,eu-central-1,157,83,74,aws-dotnet-1024
aws,dotnet,1024,eu-central-1,157,88,69,aws-dotnet-1024
aws,dotnet,1024,eu-central-1,136,79,57,aws-dotnet-1024
aws,dotnet,1024,eu-central-1,132,78,54,aws-dotnet-1024
aws,dotnet,1024,eu-central-1,153,83,70,aws-dotnet-1024
aws,dotnet,1024,eu-central-1,150,78,72,aws-dotnet-1024
aws,dotnet,1024,eu-central-1,165,78,87,aws-dotnet-1024
aws,dotnet,1024,eu-central-1,167,84,83,aws-dotnet-1024
aws,dotnet,1024,eu-central-1,144,79,65,aws-dotnet-1024
aws,dotnet,1024,eu-central-1,182,79,103,aws-dotnet-1024
aws,dotnet,1024,eu-central-1,131,74,57,aws-dotnet-1024
aws,dotnet,1024,eu-central-1,162,87,75,aws-dotnet-1024
aws,dotnet,1024,eu-central-1,157,82,75,aws-dotnet-1024
aws,dotnet,1024,eu-central-1,156,84,72,aws-dotnet-1024
aws,dotnet,1024,eu-central-1,140,78,62,aws-dotnet-1024
aws,dotnet,1024,eu-central-1,137,82,55,aws-dotnet-1024
aws,dotnet,1024,eu-central-1,155,82,73,aws-dotnet-1024
aws,dotnet,1024,eu-central-1,151,82,69,aws-dotnet-1024
aws,dotnet,1024,eu-central-1,131,80,51,aws-dotnet-1024
aws,dotnet,1024,eu-central-1,153,75,78,aws-dotnet-1024
aws,dotnet,1024,eu-central-1,141,83,58,aws-dotnet-1024
aws,dotnet,1024,eu-central-1,159,87,72,aws-dotnet-1024
aws,dotnet,1024,eu-central-1,134,83,51,aws-dotnet-1024
aws,dotnet,1024,eu-central-1,141,78,63,aws-dotnet-1024
aws,dotnet,1024,eu-central-1,153,83,70,aws-dotnet-1024
aws,dotnet,1024,eu-central-1,152,79,73,aws-dotnet-1024
aws,dotnet,1024,eu-central-1,150,87,63,aws-dotnet-1024
aws,dotnet,1024,eu-central-1,153,76,77,aws-dotnet-1024
aws,dotnet,1024,eu-central-1,133,83,50,aws-dotnet-1024
aws,dotnet,1024,eu-central-1,137,78,59,aws-dotnet-1024
aws,dotnet,1024,eu-central-1,149,86,63,aws-dotnet-1024
aws,dotnet,1024,eu-central-1,403,84,319,aws-dotnet-1024
aws,dotnet,1024,eu-central-1,133,78,55,aws-dotnet-1024
aws,dotnet,1024,eu-central-1,150,79,71,aws-dotnet-1024
aws,dotnet,1024,eu-central-1,146,82,64,aws-dotnet-1024
aws,dotnet,1024,eu-central-1,145,87,58,aws-dotnet-1024
aws,dotnet,1024,eu-central-1,145,87,58,aws-dotnet-1024
aws,dotnet,1024,eu-central-1,142,86,56,aws-dotnet-1024
aws,dotnet,1024,eu-central-1,161,78,83,aws-dotnet-1024
aws,dotnet,1024,eu-central-1,130,78,52,aws-dotnet-1024
aws,dotnet,1024,eu-central-1,145,79,66,aws-dotnet-1024
aws,dotnet,1024,eu-central-1,137,83,54,aws-dotnet-1024
aws,dotnet,1024,eu-central-1,146,78,68,aws-dotnet-1024
aws,dotnet,1024,eu-central-1,142,79,63,aws-dotnet-1024
aws,dotnet,1024,eu-central-1,145,74,71,aws-dotnet-1024
aws,dotnet,1024,eu-central-1,138,78,60,aws-dotnet-1024
aws,dotnet,1024,eu-central-1,134,83,51,aws-dotnet-1024
aws,dotnet,1024,eu-central-1,153,82,71,aws-dotnet-1024
aws,dotnet,1024,eu-central-1,153,82,71,aws-dotnet-1024
aws,dotnet,1024,eu-central-1,157,78,79,aws-dotnet-1024
aws,dotnet,1024,eu-central-1,147,75,72,aws-dotnet-1024
aws,dotnet,1024,eu-central-1,147,83,64,aws-dotnet-1024
aws,dotnet,1024,eu-central-1,150,74,76,aws-dotnet-1024
aws,dotnet,1024,eu-central-1,608,78,530,aws-dotnet-1024
aws,dotnet,1024,eu-central-1,161,80,81,aws-dotnet-1024
aws,dotnet,1024,eu-central-1,143,75,68,aws-dotnet-1024
aws,dotnet,1024,eu-central-1,158,79,79,aws-dotnet-1024
aws,dotnet,1024,eu-central-1,145,79,66,aws-dotnet-1024
aws,dotnet,1024,eu-central-1,140,79,61,aws-dotnet-1024
aws,dotnet,1024,eu-central-1,158,78,80,aws-dotnet-1024
aws,dotnet,1024,eu-central-1,140,78,62,aws-dotnet-1024
aws,dotnet,1024,eu-central-1,157,82,75,aws-dotnet-1024
aws,dotnet,1024,eu-central-1,153,86,67,aws-dotnet-1024
aws,dotnet,1024,eu-central-1,135,78,57,aws-dotnet-1024
aws,dotnet,1024,eu-central-1,155,78,77,aws-dotnet-1024
aws,dotnet,1024,eu-central-1,156,79,77,aws-dotnet-1024
aws,dotnet,1024,eu-central-1,153,78,75,aws-dotnet-1024
aws,dotnet,1024,eu-central-1,147,78,69,aws-dotnet-1024
aws,dotnet,1024,eu-central-1,133,74,59,aws-dotnet-1024
aws,dotnet,1024,eu-central-1,180,74,106,aws-dotnet-1024
aws,dotnet,1024,eu-central-1,147,78,69,aws-dotnet-1024
aws,dotnet,1024,eu-central-1,133,74,59,aws-dotnet-1024
aws,dotnet,1024,eu-central-1,133,74,59,aws-dotnet-1024
aws,dotnet,1024,eu-central-1,132,80,52,aws-dotnet-1024
aws,dotnet,1024,eu-central-1,131,79,52,aws-dotnet-1024
aws,dotnet,1024,eu-central-1,135,75,60,aws-dotnet-1024
aws,dotnet,1024,eu-central-1,148,83,65,aws-dotnet-1024
aws,dotnet,1024,eu-central-1,147,78,69,aws-dotnet-1024
aws,dotnet,1024,eu-central-1,338,82,256,aws-dotnet-1024
aws,dotnet,1024,eu-central-1,162,86,76,aws-dotnet-1024
aws,dotnet,1024,eu-central-1,126,74,52,aws-dotnet-1024
aws,dotnet,2048,eu-central-1,163,50,113,aws-dotnet-2048
aws,dotnet,2048,eu-central-1,124,50,74,aws-dotnet-2048
aws,dotnet,2048,eu-central-1,114,50,64,aws-dotnet-2048
aws,dotnet,2048,eu-central-1,102,50,52,aws-dotnet-2048
aws,dotnet,2048,eu-central-1,112,51,61,aws-dotnet-2048
aws,dotnet,2048,eu-central-1,107,50,57,aws-dotnet-2048
aws,dotnet,2048,eu-central-1,128,50,78,aws-dotnet-2048
aws,dotnet,2048,eu-central-1,135,50,85,aws-dotnet-2048
aws,dotnet,2048,eu-central-1,123,50,73,aws-dotnet-2048
aws,dotnet,2048,eu-central-1,122,50,72,aws-dotnet-2048
aws,dotnet,2048,eu-central-1,125,50,75,aws-dotnet-2048
aws,dotnet,2048,eu-central-1,112,50,62,aws-dotnet-2048
aws,dotnet,2048,eu-central-1,143,50,93,aws-dotnet-2048
aws,dotnet,2048,eu-central-1,119,50,69,aws-dotnet-2048
aws,dotnet,2048,eu-central-1,123,50,73,aws-dotnet-2048
aws,dotnet,2048,eu-central-1,110,50,60,aws-dotnet-2048
aws,dotnet,2048,eu-central-1,114,50,64,aws-dotnet-2048
aws,dotnet,2048,eu-central-1,119,50,69,aws-dotnet-2048
aws,dotnet,2048,eu-central-1,144,50,94,aws-dotnet-2048
aws,dotnet,2048,eu-central-1,125,51,74,aws-dotnet-2048
aws,dotnet,2048,eu-central-1,137,50,87,aws-dotnet-2048
aws,dotnet,2048,eu-central-1,117,50,67,aws-dotnet-2048
aws,dotnet,2048,eu-central-1,118,50,68,aws-dotnet-2048
aws,dotnet,2048,eu-central-1,117,50,67,aws-dotnet-2048
aws,dotnet,2048,eu-central-1,140,50,90,aws-dotnet-2048
aws,dotnet,2048,eu-central-1,131,50,81,aws-dotnet-2048
aws,dotnet,2048,eu-central-1,119,50,69,aws-dotnet-2048
aws,dotnet,2048,eu-central-1,105,50,55,aws-dotnet-2048
aws,dotnet,2048,eu-central-1,121,50,71,aws-dotnet-2048
aws,dotnet,2048,eu-central-1,121,50,71,aws-dotnet-2048
aws,dotnet,2048,eu-central-1,113,50,63,aws-dotnet-2048
aws,dotnet,2048,eu-central-1,127,50,77,aws-dotnet-2048
aws,dotnet,2048,eu-central-1,127,50,77,aws-dotnet-2048
aws,dotnet,2048,eu-central-1,113,50,63,aws-dotnet-2048
aws,dotnet,2048,eu-central-1,121,50,71,aws-dotnet-2048
aws,dotnet,2048,eu-central-1,124,50,74,aws-dotnet-2048
aws,dotnet,2048,eu-central-1,137,50,87,aws-dotnet-2048
aws,dotnet,2048,eu-central-1,118,50,68,aws-dotnet-2048
aws,dotnet,2048,eu-central-1,112,50,62,aws-dotnet-2048
aws,dotnet,2048,eu-central-1,125,51,74,aws-dotnet-2048
aws,dotnet,2048,eu-central-1,121,50,71,aws-dotnet-2048
aws,dotnet,2048,eu-central-1,115,50,65,aws-dotnet-2048
aws,dotnet,2048,eu-central-1,123,50,73,aws-dotnet-2048
aws,dotnet,2048,eu-central-1,132,50,82,aws-dotnet-2048
aws,dotnet,2048,eu-central-1,118,50,68,aws-dotnet-2048
aws,dotnet,2048,eu-central-1,128,50,78,aws-dotnet-2048
aws,dotnet,2048,eu-central-1,120,50,70,aws-dotnet-2048
aws,dotnet,2048,eu-central-1,122,50,72,aws-dotnet-2048
aws,dotnet,2048,eu-central-1,141,51,90,aws-dotnet-2048
aws,dotnet,2048,eu-central-1,141,50,91,aws-dotnet-2048
aws,dotnet,2048,eu-central-1,109,56,53,aws-dotnet-2048
aws,dotnet,2048,eu-central-1,133,63,70,aws-dotnet-2048
aws,dotnet,2048,eu-central-1,120,51,69,aws-dotnet-2048
aws,dotnet,2048,eu-central-1,123,50,73,aws-dotnet-2048
aws,dotnet,2048,eu-central-1,118,50,68,aws-dotnet-2048
aws,dotnet,2048,eu-central-1,104,50,54,aws-dotnet-2048
aws,dotnet,2048,eu-central-1,146,64,82,aws-dotnet-2048
aws,dotnet,2048,eu-central-1,136,61,75,aws-dotnet-2048
aws,dotnet,2048,eu-central-1,115,51,64,aws-dotnet-2048
aws,dotnet,2048,eu-central-1,117,50,67,aws-dotnet-2048
aws,dotnet,2048,eu-central-1,146,50,96,aws-dotnet-2048
aws,dotnet,2048,eu-central-1,612,50,562,aws-dotnet-2048
aws,dotnet,2048,eu-central-1,110,50,60,aws-dotnet-2048
aws,dotnet,2048,eu-central-1,117,50,67,aws-dotnet-2048
aws,dotnet,2048,eu-central-1,121,51,70,aws-dotnet-2048
aws,dotnet,2048,eu-central-1,109,50,59,aws-dotnet-2048
aws,dotnet,2048,eu-central-1,121,50,71,aws-dotnet-2048
aws,dotnet,2048,eu-central-1,123,50,73,aws-dotnet-2048
aws,dotnet,2048,eu-central-1,126,51,75,aws-dotnet-2048
aws,dotnet,2048,eu-central-1,136,50,86,aws-dotnet-2048
aws,dotnet,2048,eu-central-1,102,50,52,aws-dotnet-2048
aws,dotnet,2048,eu-central-1,114,50,64,aws-dotnet-2048
aws,dotnet,2048,eu-central-1,134,50,84,aws-dotnet-2048
aws,dotnet,2048,eu-central-1,142,50,92,aws-dotnet-2048
aws,dotnet,2048,eu-central-1,120,50,70,aws-dotnet-2048
aws,dotnet,2048,eu-central-1,132,50,82,aws-dotnet-2048
aws,dotnet,2048,eu-central-1,116,50,66,aws-dotnet-2048
aws,dotnet,2048,eu-central-1,117,50,67,aws-dotnet-2048
aws,dotnet,2048,eu-central-1,120,51,69,aws-dotnet-2048
aws,dotnet,2048,eu-central-1,120,52,68,aws-dotnet-2048
aws,dotnet,2048,eu-central-1,137,50,87,aws-dotnet-2048
aws,dotnet,2048,eu-central-1,128,50,78,aws-dotnet-2048
aws,dotnet,2048,eu-central-1,108,50,58,aws-dotnet-2048
aws,dotnet,2048,eu-central-1,113,50,63,aws-dotnet-2048
aws,dotnet,2048,eu-central-1,137,50,87,aws-dotnet-2048
aws,dotnet,2048,eu-central-1,118,50,68,aws-dotnet-2048
aws,dotnet,2048,eu-central-1,101,50,51,aws-dotnet-2048
aws,dotnet,2048,eu-central-1,126,50,76,aws-dotnet-2048
aws,dotnet,2048,eu-central-1,126,50,76,aws-dotnet-2048
aws,dotnet,2048,eu-central-1,128,50,78,aws-dotnet-2048
aws,dotnet,2048,eu-central-1,102,50,52,aws-dotnet-2048
aws,dotnet,2048,eu-central-1,127,50,77,aws-dotnet-2048
aws,dotnet,2048,eu-central-1,122,50,72,aws-dotnet-2048
aws,dotnet,2048,eu-central-1,126,50,76,aws-dotnet-2048
aws,dotnet,2048,eu-central-1,100,50,50,aws-dotnet-2048
aws,dotnet,2048,eu-central-1,128,50,78,aws-dotnet-2048
aws,dotnet,2048,eu-central-1,147,50,97,aws-dotnet-2048
aws,dotnet,2048,eu-central-1,111,50,61,aws-dotnet-2048
aws,dotnet,2048,eu-central-1,103,50,53,aws-dotnet-2048
aws,dotnet,2048,eu-central-1,121,51,70,aws-dotnet-2048
aws,go,128,eu-central-1,1123,964,159,aws-go-128
aws,go,128,eu-central-1,1061,961,100,aws-go-128
aws,go,128,eu-central-1,960,864,96,aws-go-128
aws,go,128,eu-central-1,1022,940,82,aws-go-128
aws,go,128,eu-central-1,1020,940,80,aws-go-128
aws,go,128,eu-central-1,1001,908,93,aws-go-128
aws,go,128,eu-central-1,1013,936,77,aws-go-128
aws,go,128,eu-central-1,1010,928,82,aws-go-128
aws,go,128,eu-central-1,1065,920,145,aws-go-128
aws,go,128,eu-central-1,984,888,96,aws-go-128
aws,go,128,eu-central-1,992,908,84,aws-go-128
aws,go,128,eu-central-1,1079,995,84,aws-go-128
aws,go,128,eu-central-1,989,921,68,aws-go-128
aws,go,128,eu-central-1,1040,940,100,aws-go-128
aws,go,128,eu-central-1,1022,940,82,aws-go-128
aws,go,128,eu-central-1,1038,960,78,aws-go-128
aws,go,128,eu-central-1,1015,940,75,aws-go-128
aws,go,128,eu-central-1,1053,961,92,aws-go-128
aws,go,128,eu-central-1,1008,908,100,aws-go-128
aws,go,128,eu-central-1,1024,952,72,aws-go-128
aws,go,128,eu-central-1,1026,952,74,aws-go-128
aws,go,128,eu-central-1,993,924,69,aws-go-128
aws,go,128,eu-central-1,1009,948,61,aws-go-128
aws,go,128,eu-central-1,1002,912,90,aws-go-128
aws,go,128,eu-central-1,1038,922,116,aws-go-128
aws,go,128,eu-central-1,1023,909,114,aws-go-128
aws,go,128,eu-central-1,1034,932,102,aws-go-128
aws,go,128,eu-central-1,1038,948,90,aws-go-128
aws,go,128,eu-central-1,1084,945,139,aws-go-128
aws,go,128,eu-central-1,1081,997,84,aws-go-128
aws,go,128,eu-central-1,970,887,83,aws-go-128
aws,go,128,eu-central-1,1072,988,84,aws-go-128
aws,go,128,eu-central-1,941,872,69,aws-go-128
aws,go,128,eu-central-1,992,912,80,aws-go-128
aws,go,128,eu-central-1,945,874,71,aws-go-128
aws,go,128,eu-central-1,1265,952,313,aws-go-128
aws,go,128,eu-central-1,945,860,85,aws-go-128
aws,go,128,eu-central-1,1062,972,90,aws-go-128
aws,go,128,eu-central-1,1023,936,87,aws-go-128
aws,go,128,eu-central-1,1053,977,76,aws-go-128
aws,go,128,eu-central-1,985,924,61,aws-go-128
aws,go,128,eu-central-1,1041,944,97,aws-go-128
aws,go,128,eu-central-1,996,924,72,aws-go-128
aws,go,128,eu-central-1,1016,935,81,aws-go-128
aws,go,128,eu-central-1,995,916,79,aws-go-128
aws,go,128,eu-central-1,1013,900,113,aws-go-128
aws,go,128,eu-central-1,1048,977,71,aws-go-128
aws,go,128,eu-central-1,1066,980,86,aws-go-128
aws,go,128,eu-central-1,985,880,105,aws-go-128
aws,go,128,eu-central-1,1006,940,66,aws-go-128
aws,go,128,eu-central-1,1042,940,102,aws-go-128
aws,go,128,eu-central-1,1025,941,84,aws-go-128
aws,go,128,eu-central-1,1006,924,82,aws-go-128
aws,go,128,eu-central-1,1043,968,75,aws-go-128
aws,go,128,eu-central-1,1063,975,88,aws-go-128
aws,go,128,eu-central-1,1023,954,69,aws-go-128
aws,go,128,eu-central-1,1035,961,74,aws-go-128
aws,go,128,eu-central-1,1052,964,88,aws-go-128
aws,go,128,eu-central-1,1032,957,75,aws-go-128
aws,go,128,eu-central-1,1111,999,112,aws-go-128
aws,go,128,eu-central-1,1246,943,303,aws-go-128
aws,go,128,eu-central-1,1006,898,108,aws-go-128
aws,go,128,eu-central-1,1008,936,72,aws-go-128
aws,go,128,eu-central-1,1010,940,70,aws-go-128
aws,go,128,eu-central-1,990,915,75,aws-go-128
aws,go,128,eu-central-1,1026,940,86,aws-go-128
aws,go,128,eu-central-1,1044,971,73,aws-go-128
aws,go,128,eu-central-1,946,871,75,aws-go-128
aws,go,128,eu-central-1,1081,996,85,aws-go-128
aws,go,128,eu-central-1,980,881,99,aws-go-128
aws,go,128,eu-central-1,1063,980,83,aws-go-128
aws,go,128,eu-central-1,1042,964,78,aws-go-128
aws,go,128,eu-central-1,1081,1004,77,aws-go-128
aws,go,128,eu-central-1,1003,915,88,aws-go-128
aws,go,128,eu-central-1,1057,941,116,aws-go-128
aws,go,128,eu-central-1,1069,969,100,aws-go-128
aws,go,128,eu-central-1,1038,960,78,aws-go-128
aws,go,128,eu-central-1,1257,888,369,aws-go-128
aws,go,128,eu-central-1,990,900,90,aws-go-128
aws,go,128,eu-central-1,934,848,86,aws-go-128
aws,go,128,eu-central-1,1405,972,433,aws-go-128
aws,go,128,eu-central-1,1143,976,167,aws-go-128
aws,go,128,eu-central-1,1009,932,77,aws-go-128
aws,go,128,eu-central-1,1058,979,79,aws-go-128
aws,go,128,eu-central-1,974,881,93,aws-go-128
aws,go,128,eu-central-1,1001,908,93,aws-go-128
aws,go,128,eu-central-1,1055,957,98,aws-go-128
aws,go,128,eu-central-1,1016,940,76,aws-go-128
aws,go,128,eu-central-1,992,912,80,aws-go-128
aws,go,128,eu-central-1,1013,931,82,aws-go-128
aws,go,128,eu-central-1,974,904,70,aws-go-128
aws,go,128,eu-central-1,1017,924,93,aws-go-128
aws,go,128,eu-central-1,1002,932,70,aws-go-128
aws,go,128,eu-central-1,1020,944,76,aws-go-128
aws,go,128,eu-central-1,1020,945,75,aws-go-128
aws,go,128,eu-central-1,997,928,69,aws-go-128
aws,go,128,eu-central-1,1035,904,131,aws-go-128
aws,go,128,eu-central-1,979,891,88,aws-go-128
aws,go,128,eu-central-1,973,876,97,aws-go-128
aws,go,128,eu-central-1,992,915,77,aws-go-128
aws,go,256,eu-central-1,568,460,108,aws-go-256
aws,go,256,eu-central-1,517,443,74,aws-go-256
aws,go,256,eu-central-1,498,425,73,aws-go-256
aws,go,256,eu-central-1,550,473,77,aws-go-256
aws,go,256,eu-central-1,545,466,79,aws-go-256
aws,go,256,eu-central-1,561,485,76,aws-go-256
aws,go,256,eu-central-1,524,452,72,aws-go-256
aws,go,256,eu-central-1,521,430,91,aws-go-256
aws,go,256,eu-central-1,539,472,67,aws-go-256
aws,go,256,eu-central-1,538,461,77,aws-go-256
aws,go,256,eu-central-1,518,461,57,aws-go-256
aws,go,256,eu-central-1,537,460,77,aws-go-256
aws,go,256,eu-central-1,515,448,67,aws-go-256
aws,go,256,eu-central-1,576,477,99,aws-go-256
aws,go,256,eu-central-1,532,464,68,aws-go-256
aws,go,256,eu-central-1,533,465,68,aws-go-256
aws,go,256,eu-central-1,866,472,394,aws-go-256
aws,go,256,eu-central-1,869,463,406,aws-go-256
aws,go,256,eu-central-1,522,444,78,aws-go-256
aws,go,256,eu-central-1,558,464,94,aws-go-256
aws,go,256,eu-central-1,512,436,76,aws-go-256
aws,go,256,eu-central-1,529,460,69,aws-go-256
aws,go,256,eu-central-1,527,440,87,aws-go-256
aws,go,256,eu-central-1,539,464,75,aws-go-256
aws,go,256,eu-central-1,542,469,73,aws-go-256
aws,go,256,eu-central-1,561,458,103,aws-go-256
aws,go,256,eu-central-1,559,482,77,aws-go-256
aws,go,256,eu-central-1,500,424,76,aws-go-256
aws,go,256,eu-central-1,538,464,74,aws-go-256
aws,go,256,eu-central-1,515,412,103,aws-go-256
aws,go,256,eu-central-1,532,437,95,aws-go-256
aws,go,256,eu-central-1,531,428,103,aws-go-256
aws,go,256,eu-central-1,512,441,71,aws-go-256
aws,go,256,eu-central-1,531,460,71,aws-go-256
aws,go,256,eu-central-1,528,461,67,aws-go-256
aws,go,256,eu-central-1,523,449,74,aws-go-256
aws,go,256,eu-central-1,499,429,70,aws-go-256
aws,go,256,eu-central-1,566,479,87,aws-go-256
aws,go,256,eu-central-1,544,465,79,aws-go-256
aws,go,256,eu-central-1,538,438,100,aws-go-256
aws,go,256,eu-central-1,486,424,62,aws-go-256
aws,go,256,eu-central-1,507,437,70,aws-go-256
aws,go,256,eu-central-1,509,448,61,aws-go-256
aws,go,256,eu-central-1,526,456,70,aws-go-256
aws,go,256,eu-central-1,527,442,85,aws-go-256
aws,go,256,eu-central-1,519,445,74,aws-go-256
aws,go,256,eu-central-1,516,436,80,aws-go-256
aws,go,256,eu-central-1,559,473,86,aws-go-256
aws,go,256,eu-central-1,557,487,70,aws-go-256
aws,go,256,eu-central-1,517,428,89,aws-go-256
aws,go,256,eu-central-1,685,468,217,aws-go-256
aws,go,256,eu-central-1,554,482,72,aws-go-256
aws,go,256,eu-central-1,533,449,84,aws-go-256
aws,go,256,eu-central-1,513,444,69,aws-go-256
aws,go,256,eu-central-1,569,477,92,aws-go-256
aws,go,256,eu-central-1,530,450,80,aws-go-256
aws,go,256,eu-central-1,532,436,96,aws-go-256
aws,go,256,eu-central-1,491,420,71,aws-go-256
aws,go,256,eu-central-1,513,456,57,aws-go-256
aws,go,256,eu-central-1,511,421,90,aws-go-256
aws,go,256,eu-central-1,530,473,57,aws-go-256
aws,go,256,eu-central-1,552,465,87,aws-go-256
aws,go,256,eu-central-1,534,465,69,aws-go-256
aws,go,256,eu-central-1,581,464,117,aws-go-256
aws,go,256,eu-central-1,538,464,74,aws-go-256
aws,go,256,eu-central-1,519,437,82,aws-go-256
aws,go,256,eu-central-1,539,465,74,aws-go-256
aws,go,256,eu-central-1,536,448,88,aws-go-256
aws,go,256,eu-central-1,518,453,65,aws-go-256
aws,go,256,eu-central-1,517,453,64,aws-go-256
aws,go,256,eu-central-1,528,461,67,aws-go-256
aws,go,256,eu-central-1,530,465,65,aws-go-256
aws,go,256,eu-central-1,527,457,70,aws-go-256
aws,go,256,eu-central-1,539,448,91,aws-go-256
aws,go,256,eu-central-1,526,457,69,aws-go-256
aws,go,256,eu-central-1,503,433,70,aws-go-256
aws,go,256,eu-central-1,522,449,73,aws-go-256
aws,go,256,eu-central-1,539,486,53,aws-go-256
aws,go,256,eu-central-1,522,452,70,aws-go-256
aws,go,256,eu-central-1,520,452,68,aws-go-256
aws,go,256,eu-central-1,519,449,70,aws-go-256
aws,go,256,eu-central-1,501,424,77,aws-go-256
aws,go,256,eu-central-1,692,469,223,aws-go-256
aws,go,256,eu-central-1,529,474,55,aws-go-256
aws,go,256,eu-central-1,560,485,75,aws-go-256
aws,go,256,eu-central-1,528,432,96,aws-go-256
aws,go,256,eu-central-1,549,481,68,aws-go-256
aws,go,256,eu-central-1,548,479,69,aws-go-256
aws,go,256,eu-central-1,530,448,82,aws-go-256
aws,go,256,eu-central-1,508,412,96,aws-go-256
aws,go,256,eu-central-1,528,463,65,aws-go-256
aws,go,256,eu-central-1,542,462,80,aws-go-256
aws,go,256,eu-central-1,538,469,69,aws-go-256
aws,go,256,eu-central-1,519,464,55,aws-go-256
aws,go,256,eu-central-1,519,449,70,aws-go-256
aws,go,256,eu-central-1,520,429,91,aws-go-256
aws,go,256,eu-central-1,537,470,67,aws-go-256
aws,go,256,eu-central-1,553,468,85,aws-go-256
aws,go,256,eu-central-1,633,465,168,aws-go-256
aws,go,256,eu-central-1,502,437,65,aws-go-256
aws,go,512,eu-central-1,326,205,121,aws-go-512
aws,go,512,eu-central-1,294,211,83,aws-go-512
aws,go,512,eu-central-1,295,223,72,aws-go-512
aws,go,512,eu-central-1,291,216,75,aws-go-512
aws,go,512,eu-central-1,292,219,73,aws-go-512
aws,go,512,eu-central-1,289,228,61,aws-go-512
aws,go,512,eu-central-1,287,232,55,aws-go-512
aws,go,512,eu-central-1,305,237,68,aws-go-512
aws,go,512,eu-central-1,284,216,68,aws-go-512
aws,go,512,eu-central-1,283,211,72,aws-go-512
aws,go,512,eu-central-1,290,220,70,aws-go-512
aws,go,512,eu-central-1,281,224,57,aws-go-512
aws,go,512,eu-central-1,300,227,73,aws-go-512
aws,go,512,eu-central-1,298,196,102,aws-go-512
aws,go,512,eu-central-1,281,212,69,aws-go-512
aws,go,512,eu-central-1,299,227,72,aws-go-512
aws,go,512,eu-central-1,277,215,62,aws-go-512
aws,go,512,eu-central-1,291,212,79,aws-go-512
aws,go,512,eu-central-1,295,208,87,aws-go-512
aws,go,512,eu-central-1,295,228,67,aws-go-512
aws,go,512,eu-central-1,285,215,70,aws-go-512
aws,go,512,eu-central-1,290,220,70,aws-go-512
aws,go,512,eu-central-1,293,220,73,aws-go-512
aws,go,512,eu-central-1,310,216,94,aws-go-512
aws,go,512,eu-central-1,289,224,65,aws-go-512
aws,go,512,eu-central-1,323,235,88,aws-go-512
aws,go,512,eu-central-1,336,228,108,aws-go-512
aws,go,512,eu-central-1,304,223,81,aws-go-512
aws,go,512,eu-central-1,281,224,57,aws-go-512
aws,go,512,eu-central-1,299,224,75,aws-go-512
aws,go,512,eu-central-1,314,235,79,aws-go-512
aws,go,512,eu-central-1,299,224,75,aws-go-512
aws,go,512,eu-central-1,310,219,91,aws-go-512
aws,go,512,eu-central-1,312,232,80,aws-go-512
aws,go,512,eu-central-1,295,227,68,aws-go-512
aws,go,512,eu-central-1,294,227,67,aws-go-512
aws,go,512,eu-central-1,311,215,96,aws-go-512
aws,go,512,eu-central-1,312,215,97,aws-go-512
aws,go,512,eu-central-1,330,220,110,aws-go-512
aws,go,512,eu-central-1,290,231,59,aws-go-512
aws,go,512,eu-central-1,303,215,88,aws-go-512
aws,go,512,eu-central-1,284,211,73,aws-go-512
aws,go,512,eu-central-1,282,227,55,aws-go-512
aws,go,512,eu-central-1,304,228,76,aws-go-512
aws,go,512,eu-central-1,437,212,225,aws-go-512
aws,go,512,eu-central-1,299,228,71,aws-go-512
aws,go,512,eu-central-1,313,235,78,aws-go-512
aws,go,512,eu-central-1,726,220,506,aws-go-512
aws,go,512,eu-central-1,299,228,71,aws-go-512
aws,go,512,eu-central-1,314,228,86,aws-go-512
aws,go,512,eu-central-1,295,220,75,aws-go-512
aws,go,512,eu-central-1,293,228,65,aws-go-512
aws,go,512,eu-central-1,470,231,239,aws-go-512
aws,go,512,eu-central-1,294,216,78,aws-go-512
aws,go,512,eu-central-1,293,228,65,aws-go-512
aws,go,512,eu-central-1,295,228,67,aws-go-512
aws,go,512,eu-central-1,469,223,246,aws-go-512
aws,go,512,eu-central-1,287,215,72,aws-go-512
aws,go,512,eu-central-1,271,211,60,aws-go-512
aws,go,512,eu-central-1,310,228,82,aws-go-512
aws,go,512,eu-central-1,291,223,68,aws-go-512
aws,go,512,eu-central-1,295,211,84,aws-go-512
aws,go,512,eu-central-1,312,219,93,aws-go-512
aws,go,512,eu-central-1,279,216,63,aws-go-512
aws,go,512,eu-central-1,301,220,81,aws-go-512
aws,go,512,eu-central-1,289,217,72,aws-go-512
aws,go,512,eu-central-1,291,227,64,aws-go-512
aws,go,512,eu-central-1,295,227,68,aws-go-512
aws,go,512,eu-central-1,298,223,75,aws-go-512
aws,go,512,eu-central-1,277,212,65,aws-go-512
aws,go,512,eu-central-1,293,220,73,aws-go-512
aws,go,512,eu-central-1,284,214,70,aws-go-512
aws,go,512,eu-central-1,486,228,258,aws-go-512
aws,go,512,eu-central-1,314,224,90,aws-go-512
aws,go,512,eu-central-1,287,217,70,aws-go-512
aws,go,512,eu-central-1,283,220,63,aws-go-512
aws,go,512,eu-central-1,284,216,68,aws-go-512
aws,go,512,eu-central-1,282,199,83,aws-go-512
aws,go,512,eu-central-1,682,211,471,aws-go-512
aws,go,512,eu-central-1,306,223,83,aws-go-512
aws,go,512,eu-central-1,577,221,356,aws-go-512
aws,go,512,eu-central-1,300,224,76,aws-go-512
aws,go,512,eu-central-1,317,232,85,aws-go-512
aws,go,512,eu-central-1,297,229,68,aws-go-512
aws,go,512,eu-central-1,295,224,71,aws-go-512
aws,go,512,eu-central-1,294,232,62,aws-go-512
aws,go,512,eu-central-1,295,229,66,aws-go-512
aws,go,512,eu-central-1,304,216,88,aws-go-512
aws,go,512,eu-central-1,275,217,58,aws-go-512
aws,go,512,eu-central-1,295,212,83,aws-go-512
aws,go,512,eu-central-1,299,228,71,aws-go-512
aws,go,512,eu-central-1,271,211,60,aws-go-512
aws,go,512,eu-central-1,678,228,450,aws-go-512
aws,go,512,eu-central-1,311,232,79,aws-go-512
aws,go,512,eu-central-1,299,227,72,aws-go-512
aws,go,512,eu-central-1,271,216,55,aws-go-512
aws,go,512,eu-central-1,291,216,75,aws-go-512
aws,go,512,eu-central-1,290,211,79,aws-go-512
aws,go,512,eu-central-1,288,220,68,aws-go-512
aws,go,512,eu-central-1,269,211,58,aws-go-512
aws,go,1024,eu-central-1,463,108,355,aws-go-1024
aws,go,1024,eu-central-1,180,104,76,aws-go-1024
aws,go,1024,eu-central-1,173,103,70,aws-go-1024
aws,go,1024,eu-central-1,178,91,87,aws-go-1024
aws,go,1024,eu-central-1,183,111,72,aws-go-1024
aws,go,1024,eu-central-1,188,107,81,aws-go-1024
aws,go,1024,eu-central-1,164,92,72,aws-go-1024
aws,go,1024,eu-central-1,165,95,70,aws-go-1024
aws,go,1024,eu-central-1,183,103,80,aws-go-1024
aws,go,1024,eu-central-1,182,103,79,aws-go-1024
aws,go,1024,eu-central-1,183,99,84,aws-go-1024
aws,go,1024,eu-central-1,175,106,69,aws-go-1024
aws,go,1024,eu-central-1,174,99,75,aws-go-1024
aws,go,1024,eu-central-1,225,106,119,aws-go-1024
aws,go,1024,eu-central-1,173,99,74,aws-go-1024
aws,go,1024,eu-central-1,184,107,77,aws-go-1024
aws,go,1024,eu-central-1,165,98,67,aws-go-1024
aws,go,1024,eu-central-1,198,107,91,aws-go-1024
aws,go,1024,eu-central-1,164,111,53,aws-go-1024
aws,go,1024,eu-central-1,195,103,92,aws-go-1024
aws,go,1024,eu-central-1,176,107,69,aws-go-1024
aws,go,1024,eu-central-1,176,107,69,aws-go-1024
aws,go,1024,eu-central-1,172,105,67,aws-go-1024
aws,go,1024,eu-central-1,177,111,66,aws-go-1024
aws,go,1024,eu-central-1,176,103,73,aws-go-1024
aws,go,1024,eu-central-1,181,99,82,aws-go-1024
aws,go,1024,eu-central-1,185,111,74,aws-go-1024
aws,go,1024,eu-central-1,194,107,87,aws-go-1024
aws,go,1024,eu-central-1,187,107,80,aws-go-1024
aws,go,1024,eu-central-1,181,99,82,aws-go-1024
aws,go,1024,eu-central-1,171,99,72,aws-go-1024
aws,go,1024,eu-central-1,185,111,74,aws-go-1024
aws,go,1024,eu-central-1,181,107,74,aws-go-1024
aws,go,1024,eu-central-1,178,107,71,aws-go-1024
aws,go,1024,eu-central-1,182,103,79,aws-go-1024
aws,go,1024,eu-central-1,192,107,85,aws-go-1024
aws,go,1024,eu-central-1,178,95,83,aws-go-1024
aws,go,1024,eu-central-1,169,103,66,aws-go-1024
aws,go,1024,eu-central-1,192,107,85,aws-go-1024
aws,go,1024,eu-central-1,179,106,73,aws-go-1024
aws,go,1024,eu-central-1,165,107,58,aws-go-1024
aws,go,1024,eu-central-1,170,99,71,aws-go-1024
aws,go,1024,eu-central-1,178,107,71,aws-go-1024
aws,go,1024,eu-central-1,179,107,72,aws-go-1024
aws,go,1024,eu-central-1,179,106,73,aws-go-1024
aws,go,1024,eu-central-1,182,99,83,aws-go-1024
aws,go,1024,eu-central-1,177,96,81,aws-go-1024
aws,go,1024,eu-central-1,163,96,67,aws-go-1024
aws,go,1024,eu-central-1,177,107,70,aws-go-1024
aws,go,1024,eu-central-1,177,103,74,aws-go-1024
aws,go,1024,eu-central-1,422,107,315,aws-go-1024
aws,go,1024,eu-central-1,173,106,67,aws-go-1024
aws,go,1024,eu-central-1,179,95,84,aws-go-1024
aws,go,1024,eu-central-1,170,94,76,aws-go-1024
aws,go,1024,eu-central-1,185,112,73,aws-go-1024
aws,go,1024,eu-central-1,173,99,74,aws-go-1024
aws,go,1024,eu-central-1,166,100,66,aws-go-1024
aws,go,1024,eu-central-1,189,104,85,aws-go-1024
aws,go,1024,eu-central-1,168,100,68,aws-go-1024
aws,go,1024,eu-central-1,186,103,83,aws-go-1024
aws,go,1024,eu-central-1,182,112,70,aws-go-1024
aws,go,1024,eu-central-1,166,99,67,aws-go-1024
aws,go,1024,eu-central-1,182,108,74,aws-go-1024
aws,go,1024,eu-central-1,182,99,83,aws-go-1024
aws,go,1024,eu-central-1,158,96,62,aws-go-1024
aws,go,1024,eu-central-1,180,99,81,aws-go-1024
aws,go,1024,eu-central-1,180,100,80,aws-go-1024
aws,go,1024,eu-central-1,178,107,71,aws-go-1024
aws,go,1024,eu-central-1,188,95,93,aws-go-1024
aws,go,1024,eu-central-1,174,95,79,aws-go-1024
aws,go,1024,eu-central-1,175,108,67,aws-go-1024
aws,go,1024,eu-central-1,176,100,76,aws-go-1024
aws,go,1024,eu-central-1,645,107,538,aws-go-1024
aws,go,1024,eu-central-1,188,99,89,aws-go-1024
aws,go,1024,eu-central-1,165,107,58,aws-go-1024
aws,go,1024,eu-central-1,188,99,89,aws-go-1024
aws,go,1024,eu-central-1,185,104,81,aws-go-1024
aws,go,1024,eu-central-1,180,107,73,aws-go-1024
aws,go,1024,eu-central-1,179,107,72,aws-go-1024
aws,go,1024,eu-central-1,159,95,64,aws-go-1024
aws,go,1024,eu-central-1,180,103,77,aws-go-1024
aws,go,1024,eu-central-1,183,104,79,aws-go-1024
aws,go,1024,eu-central-1,179,107,72,aws-go-1024
aws,go,1024,eu-central-1,175,111,64,aws-go-1024
aws,go,1024,eu-central-1,179,107,72,aws-go-1024
aws,go,1024,eu-central-1,202,107,95,aws-go-1024
aws,go,1024,eu-central-1,152,99,53,aws-go-1024
aws,go,1024,eu-central-1,180,103,77,aws-go-1024
aws,go,1024,eu-central-1,230,107,123,aws-go-1024
aws,go,1024,eu-central-1,176,107,69,aws-go-1024
aws,go,1024,eu-central-1,175,104,71,aws-go-1024
aws,go,1024,eu-central-1,175,103,72,aws-go-1024
aws,go,1024,eu-central-1,178,107,71,aws-go-1024
aws,go,1024,eu-central-1,175,107,68,aws-go-1024
aws,go,1024,eu-central-1,177,103,74,aws-go-1024
aws,go,1024,eu-central-1,172,103,69,aws-go-1024
aws,go,1024,eu-central-1,191,107,84,aws-go-1024
aws,go,1024,eu-central-1,364,107,257,aws-go-1024
aws,go,1024,eu-central-1,182,95,87,aws-go-1024
aws,go,1024,eu-central-1,166,97,69,aws-go-1024
aws,go,2048,eu-central-1,175,70,105,aws-go-2048
aws,go,2048,eu-central-1,123,63,60,aws-go-2048
aws,go,2048,eu-central-1,143,63,80,aws-go-2048
aws,go,2048,eu-central-1,117,63,54,aws-go-2048
aws,go,2048,eu-central-1,136,63,73,aws-go-2048
aws,go,2048,eu-central-1,139,63,76,aws-go-2048
aws,go,2048,eu-central-1,120,63,57,aws-go-2048
aws,go,2048,eu-central-1,118,63,55,aws-go-2048
aws,go,2048,eu-central-1,118,63,55,aws-go-2048
aws,go,2048,eu-central-1,125,64,61,aws-go-2048
aws,go,2048,eu-central-1,147,63,84,aws-go-2048
aws,go,2048,eu-central-1,129,63,66,aws-go-2048
aws,go,2048,eu-central-1,147,63,84,aws-go-2048
aws,go,2048,eu-central-1,129,63,66,aws-go-2048
aws,go,2048,eu-central-1,129,63,66,aws-go-2048
aws,go,2048,eu-central-1,124,62,62,aws-go-2048
aws,go,2048,eu-central-1,122,63,59,aws-go-2048
aws,go,2048,eu-central-1,121,63,58,aws-go-2048
aws,go,2048,eu-central-1,124,63,61,aws-go-2048
aws,go,2048,eu-central-1,133,63,70,aws-go-2048
aws,go,2048,eu-central-1,148,63,85,aws-go-2048
aws,go,2048,eu-central-1,121,63,58,aws-go-2048
aws,go,2048,eu-central-1,123,63,60,aws-go-2048
aws,go,2048,eu-central-1,138,63,75,aws-go-2048
aws,go,2048,eu-central-1,130,63,67,aws-go-2048
aws,go,2048,eu-central-1,153,63,90,aws-go-2048
aws,go,2048,eu-central-1,124,62,62,aws-go-2048
aws,go,2048,eu-central-1,118,63,55,aws-go-2048
aws,go,2048,eu-central-1,120,63,57,aws-go-2048
aws,go,2048,eu-central-1,124,63,61,aws-go-2048
aws,go,2048,eu-central-1,119,63,56,aws-go-2048
aws,go,2048,eu-central-1,130,63,67,aws-go-2048
aws,go,2048,eu-central-1,128,63,65,aws-go-2048
aws,go,2048,eu-central-1,127,63,64,aws-go-2048
aws,go,2048,eu-central-1,123,63,60,aws-go-2048
aws,go,2048,eu-central-1,126,63,63,aws-go-2048
aws,go,2048,eu-central-1,139,63,76,aws-go-2048
aws,go,2048,eu-central-1,144,66,78,aws-go-2048
aws,go,2048,eu-central-1,126,63,63,aws-go-2048
aws,go,2048,eu-central-1,140,65,75,aws-go-2048
aws,go,2048,eu-central-1,124,63,61,aws-go-2048
aws,go,2048,eu-central-1,127,63,64,aws-go-2048
aws,go,2048,eu-central-1,116,63,53,aws-go-2048
aws,go,2048,eu-central-1,137,62,75,aws-go-2048
aws,go,2048,eu-central-1,138,63,75,aws-go-2048
aws,go,2048,eu-central-1,142,63,79,aws-go-2048
aws,go,2048,eu-central-1,119,63,56,aws-go-2048
aws,go,2048,eu-central-1,126,63,63,aws-go-2048
aws,go,2048,eu-central-1,126,63,63,aws-go-2048
aws,go,2048,eu-central-1,149,63,86,aws-go-2048
aws,go,2048,eu-central-1,127,63,64,aws-go-2048
aws,go,2048,eu-central-1,120,63,57,aws-go-2048
aws,go,2048,eu-central-1,122,63,59,aws-go-2048
aws,go,2048,eu-central-1,126,63,63,aws-go-2048
aws,go,2048,eu-central-1,128,63,65,aws-go-2048
aws,go,2048,eu-central-1,132,63,69,aws-go-2048
aws,go,2048,eu-central-1,140,62,78,aws-go-2048
aws,go,2048,eu-central-1,120,63,57,aws-go-2048
aws,go,2048,eu-central-1,142,63,79,aws-go-2048
aws,go,2048,eu-central-1,152,65,87,aws-go-2048
aws,go,2048,eu-central-1,148,63,85,aws-go-2048
aws,go,2048,eu-central-1,619,63,556,aws-go-2048
aws,go,2048,eu-central-1,134,62,72,aws-go-2048
aws,go,2048,eu-central-1,129,62,67,aws-go-2048
aws,go,2048,eu-central-1,137,63,74,aws-go-2048
aws,go,2048,eu-central-1,125,62,63,aws-go-2048
aws,go,2048,eu-central-1,117,63,54,aws-go-2048
aws,go,2048,eu-central-1,128,63,65,aws-go-2048
aws,go,2048,eu-central-1,126,63,63,aws-go-2048
aws,go,2048,eu-central-1,140,62,78,aws-go-2048
aws,go,2048,eu-central-1,136,62,74,aws-go-2048
aws,go,2048,eu-central-1,129,62,67,aws-go-2048
aws,go,2048,eu-central-1,129,62,67,aws-go-2048
aws,go,2048,eu-central-1,122,63,59,aws-go-2048
aws,go,2048,eu-central-1,142,63,79,aws-go-2048
aws,go,2048,eu-central-1,138,63,75,aws-go-2048
aws,go,2048,eu-central-1,215,62,153,aws-go-2048
aws,go,2048,eu-central-1,120,62,58,aws-go-2048
aws,go,2048,eu-central-1,139,68,71,aws-go-2048
aws,go,2048,eu-central-1,122,62,60,aws-go-2048
aws,go,2048,eu-central-1,156,63,93,aws-go-2048
aws,go,2048,eu-central-1,128,62,66,aws-go-2048
aws,go,2048,eu-central-1,170,62,108,aws-go-2048
aws,go,2048,eu-central-1,131,62,69,aws-go-2048
aws,go,2048,eu-central-1,127,62,65,aws-go-2048
aws,go,2048,eu-central-1,133,63,70,aws-go-2048
aws,go,2048,eu-central-1,134,63,71,aws-go-2048
aws,go,2048,eu-central-1,133,63,70,aws-go-2048
aws,go,2048,eu-central-1,134,63,71,aws-go-2048
aws,go,2048,eu-central-1,135,63,72,aws-go-2048
aws,go,2048,eu-central-1,116,63,53,aws-go-2048
aws,go,2048,eu-central-1,130,69,61,aws-go-2048
aws,go,2048,eu-central-1,145,63,82,aws-go-2048
aws,go,2048,eu-central-1,143,63,80,aws-go-2048
aws,go,2048,eu-central-1,120,63,57,aws-go-2048
aws,go,2048,eu-central-1,129,63,66,aws-go-2048
aws,go,2048,eu-central-1,133,63,70,aws-go-2048
aws,go,2048,eu-central-1,130,63,67,aws-go-2048
aws,go,2048,eu-central-1,130,63,67,aws-go-2048
aws,go,2048,eu-central-1,121,62,59,aws-go-2048
aws,node,128,eu-central-1,18296,18083,213,aws-node-128
aws,node,128,eu-central-1,17545,17103,442,aws-node-128
aws,node,128,eu-central-1,17453,17022,431,aws-node-128
aws,node,128,eu-central-1,17364,16903,461,aws-node-128
aws,node,128,eu-central-1,18576,18377,199,aws-node-128
aws,node,128,eu-central-1,17018,16848,170,aws-node-128
aws,node,128,eu-central-1,16882,16725,157,aws-node-128
aws,node,128,eu-central-1,16752,16581,171,aws-node-128
aws,node,128,eu-central-1,18765,18152,613,aws-node-128
aws,node,128,eu-central-1,17063,16851,212,aws-node-128
aws,node,128,eu-central-1,17197,17053,144,aws-node-128
aws,node,128,eu-central-1,16918,16751,167,aws-node-128
aws,node,128,eu-central-1,18287,18138,149,aws-node-128
aws,node,128,eu-central-1,16797,16646,151,aws-node-128
aws,node,128,eu-central-1,16975,16825,150,aws-node-128
aws,node,128,eu-central-1,16657,16492,165,aws-node-128
aws,node,128,eu-central-1,18217,18088,129,aws-node-128
aws,node,128,eu-central-1,16997,16858,139,aws-node-128
aws,node,128,eu-central-1,17081,16914,167,aws-node-128
aws,node,128,eu-central-1,16839,16704,135,aws-node-128
aws,node,128,eu-central-1,18284,18107,177,aws-node-128
aws,node,128,eu-central-1,16774,16667,107,aws-node-128
aws,node,128,eu-central-1,16941,16788,153,aws-node-128
aws,node,128,eu-central-1,16659,16491,168,aws-node-128
aws,node,128,eu-central-1,18241,18080,161,aws-node-128
aws,node,128,eu-central-1,17125,16960,165,aws-node-128
aws,node,128,eu-central-1,17007,16801,206,aws-node-128
aws,node,128,eu-central-1,16636,16502,134,aws-node-128
aws,node,128,eu-central-1,18452,18299,153,aws-node-128
aws,node,128,eu-central-1,17000,16881,119,aws-node-128
aws,node,128,eu-central-1,16957,16815,142,aws-node-128
aws,node,128,eu-central-1,16851,16681,170,aws-node-128
aws,node,128,eu-central-1,18059,17909,150,aws-node-128
aws,node,128,eu-central-1,17071,16926,145,aws-node-128
aws,node,128,eu-central-1,16933,16787,146,aws-node-128
aws,node,128,eu-central-1,17065,16686,379,aws-node-128
aws,node,128,eu-central-1,18278,18101,177,aws-node-128
aws,node,128,eu-central-1,17085,16930,155,aws-node-128
aws,node,128,eu-central-1,16871,16668,203,aws-node-128
aws,node,128,eu-central-1,16773,16649,124,aws-node-128
aws,node,128,eu-central-1,18239,18086,153,aws-node-128
aws,node,128,eu-central-1,16764,16613,151,aws-node-128
aws,node,128,eu-central-1,17012,16869,143,aws-node-128
aws,node,128,eu-central-1,16812,16681,131,aws-node-128
aws,node,128,eu-central-1,18286,18105,181,aws-node-128
aws,node,128,eu-central-1,16753,16573,180,aws-node-128
aws,node,128,eu-central-1,17058,16905,153,aws-node-128
aws,node,128,eu-central-1,16703,16560,143,aws-node-128
aws,node,128,eu-central-1,18259,18062,197,aws-node-128
aws,node,128,eu-central-1,16786,16613,173,aws-node-128
aws,node,128,eu-central-1,17130,16969,161,aws-node-128
aws,node,128,eu-central-1,16625,16489,136,aws-node-128
aws,node,128,eu-central-1,18482,18314,168,aws-node-128
aws,node,128,eu-central-1,17173,16926,247,aws-node-128
aws,node,128,eu-central-1,17076,16927,149,aws-node-128
aws,node,128,eu-central-1,16618,16454,164,aws-node-128
aws,node,128,eu-central-1,18131,17988,143,aws-node-128
aws,node,128,eu-central-1,17133,16964,169,aws-node-128
aws,node,128,eu-central-1,17025,16865,160,aws-node-128
aws,node,128,eu-central-1,16770,16630,140,aws-node-128
aws,node,128,eu-central-1,18370,18173,197,aws-node-128
aws,node,128,eu-central-1,16969,16800,169,aws-node-128
aws,node,128,eu-central-1,16878,16696,182,aws-node-128
aws,node,128,eu-central-1,16766,16643,123,aws-node-128
aws,node,128,eu-central-1,18202,18060,142,aws-node-128
aws,node,128,eu-central-1,17051,16855,196,aws-node-128
aws,node,128,eu-central-1,16918,16732,186,aws-node-128
aws,node,128,eu-central-1,16745,16573,172,aws-node-128
aws,node,128,eu-central-1,18359,18212,147,aws-node-128
aws,node,128,eu-central-1,17184,17037,147,aws-node-128
aws,node,128,eu-central-1,16976,16810,166,aws-node-128
aws,node,128,eu-central-1,16717,16577,140,aws-node-128
aws,node,128,eu-central-1,17418,17297,121,aws-node-128
aws,node,128,eu-central-1,16966,16766,200,aws-node-128
aws,node,128,eu-central-1,16873,16710,163,aws-node-128
aws,node,128,eu-central-1,16636,16480,156,aws-node-128
aws,node,128,eu-central-1,17411,17271,140,aws-node-128
aws,node,128,eu-central-1,16833,16689,144,aws-node-128
aws,node,128,eu-central-1,17044,16913,131,aws-node-128
aws,node,128,eu-central-1,16894,16755,139,aws-node-128
aws,node,128,eu-central-1,17581,17100,481,aws-node-128
aws,node,128,eu-central-1,16864,16629,235,aws-node-128
aws,node,128,eu-central-1,16979,16818,161,aws-node-128
aws,node,128,eu-central-1,16816,16699,117,aws-node-128
aws,node,128,eu-central-1,17473,17331,142,aws-node-128
aws,node,128,eu-central-1,16798,16677,121,aws-node-128
aws,node,128,eu-central-1,16908,16757,151,aws-node-128
aws,node,128,eu-central-1,16831,16674,157,aws-node-128
aws,node,128,eu-central-1,17369,17230,139,aws-node-128
aws,node,128,eu-central-1,16851,16668,183,aws-node-128
aws,node,128,eu-central-1,16784,16646,138,aws-node-128
aws,node,128,eu-central-1,16917,16765,152,aws-node-128
aws,node,128,eu-central-1,17398,17258,140,aws-node-128
aws,node,128,eu-central-1,17041,16887,154,aws-node-128
aws,node,128,eu-central-1,16976,16750,226,aws-node-128
aws,node,128,eu-central-1,16676,16549,127,aws-node-128
aws,node,128,eu-central-1,17324,17161,163,aws-node-128
aws,node,128,eu-central-1,16964,16772,192,aws-node-128
aws,node,128,eu-central-1,16883,16722,161,aws-node-128
aws,node,128,eu-central-1,16725,16567,158,aws-node-128
aws,node,256,eu-central-1,9443,9264,179,aws-node-256
aws,node,256,eu-central-1,8779,8418,361,aws-node-256
aws,node,256,eu-central-1,9264,9129,135,aws-node-256
aws,node,256,eu-central-1,8488,8361,127,aws-node-256
aws,node,256,eu-central-1,9335,9195,140,aws-node-256
aws,node,256,eu-central-1,8382,8272,110,aws-node-256
aws,node,256,eu-central-1,9171,9039,132,aws-node-256
aws,node,256,eu-central-1,8517,8367,150,aws-node-256
aws,node,256,eu-central-1,9390,9245,145,aws-node-256
aws,node,256,eu-central-1,8319,8201,118,aws-node-256
aws,node,256,eu-central-1,9385,9273,112,aws-node-256
aws,node,256,eu-central-1,8456,8326,130,aws-node-256
aws,node,256,eu-central-1,9244,9095,149,aws-node-256
aws,node,256,eu-central-1,8373,8222,151,aws-node-256
aws,node,256,eu-central-1,9365,9234,131,aws-node-256
aws,node,256,eu-central-1,8390,8260,130,aws-node-256
aws,node,256,eu-central-1,9657,9210,447,aws-node-256
aws,node,256,eu-central-1,8787,8329,458,aws-node-256
aws,node,256,eu-central-1,9309,9159,150,aws-node-256
aws,node,256,eu-central-1,8497,8370,127,aws-node-256
aws,node,256,eu-central-1,9382,9243,139,aws-node-256
aws,node,256,eu-central-1,8547,8258,289,aws-node-256
aws,node,256,eu-central-1,9238,9094,144,aws-node-256
aws,node,256,eu-central-1,8478,8337,141,aws-node-256
aws,node,256,eu-central-1,9387,9257,130,aws-node-256
aws,node,256,eu-central-1,8517,8361,156,aws-node-256
aws,node,256,eu-central-1,9294,9142,152,aws-node-256
aws,node,256,eu-central-1,8500,8337,163,aws-node-256
aws,node,256,eu-central-1,9347,9240,107,aws-node-256
aws,node,256,eu-central-1,8439,8340,99,aws-node-256
aws,node,256,eu-central-1,9521,9127,394,aws-node-256
aws,node,256,eu-central-1,8350,8209,141,aws-node-256
aws,node,256,eu-central-1,9382,9260,122,aws-node-256
aws,node,256,eu-central-1,8374,8255,119,aws-node-256
aws,node,256,eu-central-1,9178,9080,98,aws-node-256
aws,node,256,eu-central-1,8794,8324,470,aws-node-256
aws,node,256,eu-central-1,9409,9289,120,aws-node-256
aws,node,256,eu-central-1,8340,8199,141,aws-node-256
aws,node,256,eu-central-1,9232,9056,176,aws-node-256
aws,node,256,eu-central-1,8458,8314,144,aws-node-256
aws,node,256,eu-central-1,9415,9298,117,aws-node-256
aws,node,256,eu-central-1,8367,8232,135,aws-node-256
aws,node,256,eu-central-1,9200,9062,138,aws-node-256
aws,node,256,eu-central-1,8399,8254,145,aws-node-256
aws,node,256,eu-central-1,9414,9277,137,aws-node-256
aws,node,256,eu-central-1,8357,8234,123,aws-node-256
aws,node,256,eu-central-1,9347,9181,166,aws-node-256
aws,node,256,eu-central-1,8416,8274,142,aws-node-256
aws,node,256,eu-central-1,9286,9165,121,aws-node-256
aws,node,256,eu-central-1,8376,8227,149,aws-node-256
aws,node,256,eu-central-1,9185,9066,119,aws-node-256
aws,node,256,eu-central-1,8329,8211,118,aws-node-256
aws,node,256,eu-central-1,9303,9181,122,aws-node-256
aws,node,256,eu-central-1,8376,8248,128,aws-node-256
aws,node,256,eu-central-1,9299,9150,149,aws-node-256
aws,node,256,eu-central-1,8470,8348,122,aws-node-256
aws,node,256,eu-central-1,9425,9286,139,aws-node-256
aws,node,256,eu-central-1,8471,8331,140,aws-node-256
aws,node,256,eu-central-1,9301,9175,126,aws-node-256
aws,node,256,eu-central-1,8477,8326,151,aws-node-256
aws,node,256,eu-central-1,9361,9239,122,aws-node-256
aws,node,256,eu-central-1,8375,8247,128,aws-node-256
aws,node,256,eu-central-1,9320,9171,149,aws-node-256
aws,node,256,eu-central-1,8420,8276,144,aws-node-256
aws,node,256,eu-central-1,9287,9147,140,aws-node-256
aws,node,256,eu-central-1,8451,8238,213,aws-node-256
aws,node,256,eu-central-1,9169,9049,120,aws-node-256
aws,node,256,eu-central-1,8516,8377,139,aws-node-256
aws,node,256,eu-central-1,9344,9204,140,aws-node-256
aws,node,256,eu-central-1,8451,8341,110,aws-node-256
aws,node,256,eu-central-1,9221,9085,136,aws-node-256
aws,node,256,eu-central-1,8489,8341,148,aws-node-256
aws,node,256,eu-central-1,9254,9113,141,aws-node-256
aws,node,256,eu-central-1,8479,8332,147,aws-node-256
aws,node,256,eu-central-1,9174,9033,141,aws-node-256
aws,node,256,eu-central-1,8418,8302,116,aws-node-256
aws,node,256,eu-central-1,9251,9133,118,aws-node-256
aws,node,256,eu-central-1,8337,8208,129,aws-node-256
aws,node,256,eu-central-1,9189,9055,134,aws-node-256
aws,node,256,eu-central-1,8375,8248,127,aws-node-256
aws,node,256,eu-central-1,9289,9177,112,aws-node-256
aws,node,256,eu-central-1,8480,8335,145,aws-node-256
aws,node,256,eu-central-1,9193,9069,124,aws-node-256
aws,node,256,eu-central-1,8390,8291,99,aws-node-256
aws,node,256,eu-central-1,8903,8773,130,aws-node-256
aws,node,256,eu-central-1,8366,8230,136,aws-node-256
aws,node,256,eu-central-1,8816,8688,128,aws-node-256
aws,node,256,eu-central-1,8549,8434,115,aws-node-256
aws,node,256,eu-central-1,8836,8685,151,aws-node-256
aws,node,256,eu-central-1,8467,8332,135,aws-node-256
aws,node,256,eu-central-1,8913,8779,134,aws-node-256
aws,node,256,eu-central-1,8500,8355,145,aws-node-256
aws,node,256,eu-central-1,8816,8670,146,aws-node-256
aws,node,256,eu-central-1,8419,8270,149,aws-node-256
aws,node,256,eu-central-1,8906,8788,118,aws-node-256
aws,node,256,eu-central-1,8459,8307,152,aws-node-256
aws,node,256,eu-central-1,8845,8729,116,aws-node-256
aws,node,256,eu-central-1,8473,8335,138,aws-node-256
aws,node,256,eu-central-1,8925,8696,229,aws-node-256
aws,node,256,eu-central-1,8503,8378,125,aws-node-256
aws,node,512,eu-central-1,4719,4569,150,aws-node-512
aws,node,512,eu-central-1,4581,4459,122,aws-node-512
aws,node,512,eu-central-1,4641,4515,126,aws-node-512
aws,node,512,eu-central-1,4563,4453,110,aws-node-512
aws,node,512,eu-central-1,4608,4505,103,aws-node-512
aws,node,512,eu-central-1,4620,4498,122,aws-node-512
aws,node,512,eu-central-1,4561,4444,117,aws-node-512
aws,node,512,eu-central-1,4606,4504,102,aws-node-512
aws,node,512,eu-central-1,4557,4460,97,aws-node-512
aws,node,512,eu-central-1,4668,4495,173,aws-node-512
aws,node,512,eu-central-1,4598,4499,99,aws-node-512
aws,node,512,eu-central-1,4609,4501,108,aws-node-512
aws,node,512,eu-central-1,4589,4440,149,aws-node-512
aws,node,512,eu-central-1,4615,4511,104,aws-node-512
aws,node,512,eu-central-1,4556,4457,99,aws-node-512
aws,node,512,eu-central-1,4615,4509,106,aws-node-512
aws,node,512,eu-central-1,4527,4422,105,aws-node-512
aws,node,512,eu-central-1,4645,4514,131,aws-node-512
aws,node,512,eu-central-1,4619,4476,143,aws-node-512
aws,node,512,eu-central-1,5066,4519,547,aws-node-512
aws,node,512,eu-central-1,4544,4440,104,aws-node-512
aws,node,512,eu-central-1,4636,4499,137,aws-node-512
aws,node,512,eu-central-1,4538,4412,126,aws-node-512
aws,node,512,eu-central-1,4620,4512,108,aws-node-512
aws,node,512,eu-central-1,4582,4468,114,aws-node-512
aws,node,512,eu-central-1,4606,4492,114,aws-node-512
aws,node,512,eu-central-1,4558,4444,114,aws-node-512
aws,node,512,eu-central-1,4631,4490,141,aws-node-512
aws,node,512,eu-central-1,4574,4470,104,aws-node-512
aws,node,512,eu-central-1,4667,4474,193,aws-node-512
aws,node,512,eu-central-1,4569,4443,126,aws-node-512
aws,node,512,eu-central-1,4571,4456,115,aws-node-512
aws,node,512,eu-central-1,4606,4491,115,aws-node-512
aws,node,512,eu-central-1,4570,4458,112,aws-node-512
aws,node,512,eu-central-1,4588,4473,115,aws-node-512
aws,node,512,eu-central-1,4527,4432,95,aws-node-512
aws,node,512,eu-central-1,4606,4487,119,aws-node-512
aws,node,512,eu-central-1,4579,4448,131,aws-node-512
aws,node,512,eu-central-1,4623,4505,118,aws-node-512
aws,node,512,eu-central-1,4579,4452,127,aws-node-512
aws,node,512,eu-central-1,4622,4518,104,aws-node-512
aws,node,512,eu-central-1,4557,4444,113,aws-node-512
aws,node,512,eu-central-1,4438,4314,124,aws-node-512
aws,node,512,eu-central-1,4382,4249,133,aws-node-512
aws,node,512,eu-central-1,4442,4323,119,aws-node-512
aws,node,512,eu-central-1,4374,4243,131,aws-node-512
aws,node,512,eu-central-1,4412,4292,120,aws-node-512
aws,node,512,eu-central-1,4388,4255,133,aws-node-512
aws,node,512,eu-central-1,4445,4318,127,aws-node-512
aws,node,512,eu-central-1,4413,4306,107,aws-node-512
aws,node,512,eu-central-1,4363,4233,130,aws-node-512
aws,node,512,eu-central-1,4404,4298,106,aws-node-512
aws,node,512,eu-central-1,4509,4252,257,aws-node-512
aws,node,512,eu-central-1,4429,4306,123,aws-node-512
aws,node,512,eu-central-1,4365,4257,108,aws-node-512
aws,node,512,eu-central-1,4423,4310,113,aws-node-512
aws,node,512,eu-central-1,4577,4273,304,aws-node-512
aws,node,512,eu-central-1,4423,4325,98,aws-node-512
aws,node,512,eu-central-1,4544,4244,300,aws-node-512
aws,node,512,eu-central-1,4439,4291,148,aws-node-512
aws,node,512,eu-central-1,4417,4270,147,aws-node-512
aws,node,512,eu-central-1,4890,4321,569,aws-node-512
aws,node,512,eu-central-1,4388,4260,128,aws-node-512
aws,node,512,eu-central-1,4428,4309,119,aws-node-512
aws,node,512,eu-central-1,4387,4271,116,aws-node-512
aws,node,512,eu-central-1,4441,4305,136,aws-node-512
aws,node,512,eu-central-1,4377,4267,110,aws-node-512
aws,node,512,eu-central-1,4413,4306,107,aws-node-512
aws,node,512,eu-central-1,4391,4276,115,aws-node-512
aws,node,512,eu-central-1,4408,4312,96,aws-node-512
aws,node,512,eu-central-1,4347,4239,108,aws-node-512
aws,node,512,eu-central-1,4369,4257,112,aws-node-512
aws,node,512,eu-central-1,4634,4314,320,aws-node-512
aws,node,512,eu-central-1,4373,4246,127,aws-node-512
aws,node,512,eu-central-1,4441,4339,102,aws-node-512
aws,node,512,eu-central-1,4379,4267,112,aws-node-512
aws,node,512,eu-central-1,4447,4315,132,aws-node-512
aws,node,512,eu-central-1,4362,4263,99,aws-node-512
aws,node,512,eu-central-1,4872,4324,548,aws-node-512
aws,node,512,eu-central-1,4383,4266,117,aws-node-512
aws,node,512,eu-central-1,4712,4309,403,aws-node-512
aws,node,512,eu-central-1,4432,4330,102,aws-node-512
aws,node,512,eu-central-1,4393,4270,123,aws-node-512
aws,node,512,eu-central-1,4432,4307,125,aws-node-512
aws,node,512,eu-central-1,4372,4249,123,aws-node-512
aws,node,512,eu-central-1,4430,4319,111,aws-node-512
aws,node,512,eu-central-1,4374,4274,100,aws-node-512
aws,node,512,eu-central-1,4407,4304,103,aws-node-512
aws,node,512,eu-central-1,4764,4237,527,aws-node-512
aws,node,512,eu-central-1,4369,4253,116,aws-node-512
aws,node,512,eu-central-1,4423,4306,117,aws-node-512
aws,node,512,eu-central-1,4364,4248,116,aws-node-512
aws,node,512,eu-central-1,4467,4324,143,aws-node-512
aws,node,512,eu-central-1,4406,4312,94,aws-node-512
aws,node,512,eu-central-1,4427,4309,118,aws-node-512
aws,node,512,eu-central-1,4379,4267,112,aws-node-512
aws,node,512,eu-central-1,4449,4343,106,aws-node-512
aws,node,512,eu-central-1,4425,4303,122,aws-node-512
aws,node,512,eu-central-1,4427,4327,100,aws-node-512
aws,node,512,eu-central-1,4400,4283,117,aws-node-512
aws,node,1024,eu-central-1,2510,2116,394,aws-node-1024
aws,node,1024,eu-central-1,2200,2079,121,aws-node-1024
aws,node,1024,eu-central-1,2184,2085,99,aws-node-1024
aws,node,1024,eu-central-1,2196,2069,127,aws-node-1024
aws,node,1024,eu-central-1,2218,2104,114,aws-node-1024
aws,node,1024,eu-central-1,2220,2103,117,aws-node-1024
aws,node,1024,eu-central-1,2261,2078,183,aws-node-1024
aws,node,1024,eu-central-1,2196,2088,108,aws-node-1024
aws,node,1024,eu-central-1,2175,2075,100,aws-node-1024
aws,node,1024,eu-central-1,2192,2062,130,aws-node-1024
aws,node,1024,eu-central-1,2210,2095,115,aws-node-1024
aws,node,1024,eu-central-1,2171,2063,108,aws-node-1024
aws,node,1024,eu-central-1,2229,2090,139,aws-node-1024
aws,node,1024,eu-central-1,2219,2082,137,aws-node-1024
aws,node,1024,eu-central-1,2216,2095,121,aws-node-1024
aws,node,1024,eu-central-1,2199,2081,118,aws-node-1024
aws,node,1024,eu-central-1,2197,2096,101,aws-node-1024
aws,node,1024,eu-central-1,2207,2070,137,aws-node-1024
aws,node,1024,eu-central-1,2216,2117,99,aws-node-1024
aws,node,1024,eu-central-1,2219,2084,135,aws-node-1024
aws,node,1024,eu-central-1,2221,2107,114,aws-node-1024
aws,node,1024,eu-central-1,2185,2081,104,aws-node-1024
aws,node,1024,eu-central-1,2216,2098,118,aws-node-1024
aws,node,1024,eu-central-1,2198,2080,118,aws-node-1024
aws,node,1024,eu-central-1,2216,2103,113,aws-node-1024
aws,node,1024,eu-central-1,2222,2085,137,aws-node-1024
aws,node,1024,eu-central-1,2211,2092,119,aws-node-1024
aws,node,1024,eu-central-1,2231,2118,113,aws-node-1024
aws,node,1024,eu-central-1,2609,2070,539,aws-node-1024
aws,node,1024,eu-central-1,2209,2098,111,aws-node-1024
aws,node,1024,eu-central-1,2194,2075,119,aws-node-1024
aws,node,1024,eu-central-1,2219,2108,111,aws-node-1024
aws,node,1024,eu-central-1,2203,2073,130,aws-node-1024
aws,node,1024,eu-central-1,2215,2104,111,aws-node-1024
aws,node,1024,eu-central-1,2199,2086,113,aws-node-1024
aws,node,1024,eu-central-1,2240,2109,131,aws-node-1024
aws,node,1024,eu-central-1,2187,2075,112,aws-node-1024
aws,node,1024,eu-central-1,2195,2099,96,aws-node-1024
aws,node,1024,eu-central-1,2544,2078,466,aws-node-1024
aws,node,1024,eu-central-1,2228,2099,129,aws-node-1024
aws,node,1024,eu-central-1,2172,2065,107,aws-node-1024
aws,node,1024,eu-central-1,2205,2095,110,aws-node-1024
aws,node,1024,eu-central-1,2167,2064,103,aws-node-1024
aws,node,1024,eu-central-1,2196,2085,111,aws-node-1024
aws,node,1024,eu-central-1,2183,2064,119,aws-node-1024
aws,node,1024,eu-central-1,2205,2093,112,aws-node-1024
aws,node,1024,eu-central-1,2178,2056,122,aws-node-1024
aws,node,1024,eu-central-1,2204,2092,112,aws-node-1024
aws,node,1024,eu-central-1,2179,2065,114,aws-node-1024
aws,node,1024,eu-central-1,2189,2070,119,aws-node-1024
aws,node,1024,eu-central-1,2396,2059,337,aws-node-1024
aws,node,1024,eu-central-1,2177,2080,97,aws-node-1024
aws,node,1024,eu-central-1,2381,2045,336,aws-node-1024
aws,node,1024,eu-central-1,2197,2075,122,aws-node-1024
aws,node,1024,eu-central-1,2679,2059,620,aws-node-1024
aws,node,1024,eu-central-1,2195,2077,118,aws-node-1024
aws,node,1024,eu-central-1,2152,2053,99,aws-node-1024
aws,node,1024,eu-central-1,2193,2070,123,aws-node-1024
aws,node,1024,eu-central-1,2172,2060,112,aws-node-1024
aws,node,1024,eu-central-1,2177,2065,112,aws-node-1024
aws,node,1024,eu-central-1,2178,2052,126,aws-node-1024
aws,node,1024,eu-central-1,2187,2062,125,aws-node-1024
aws,node,1024,eu-central-1,2193,2068,125,aws-node-1024
aws,node,1024,eu-central-1,2181,2070,111,aws-node-1024
aws,node,1024,eu-central-1,2347,2065,282,aws-node-1024
aws,node,1024,eu-central-1,2199,2072,127,aws-node-1024
aws,node,1024,eu-central-1,2177,2061,116,aws-node-1024
aws,node,1024,eu-central-1,2185,2065,120,aws-node-1024
aws,node,1024,eu-central-1,2198,2076,122,aws-node-1024
aws,node,1024,eu-central-1,2162,2055,107,aws-node-1024
aws,node,1024,eu-central-1,2213,2080,133,aws-node-1024
aws,node,1024,eu-central-1,2181,2060,121,aws-node-1024
aws,node,1024,eu-central-1,2662,2077,585,aws-node-1024
aws,node,1024,eu-central-1,2193,2068,125,aws-node-1024
aws,node,1024,eu-central-1,2202,2086,116,aws-node-1024
aws,node,1024,eu-central-1,2191,2069,122,aws-node-1024
aws,node,1024,eu-central-1,2175,2076,99,aws-node-1024
aws,node,1024,eu-central-1,2180,2056,124,aws-node-1024
aws,node,1024,eu-central-1,2191,2079,112,aws-node-1024
aws,node,1024,eu-central-1,2168,2063,105,aws-node-1024
aws,node,1024,eu-central-1,2206,2086,120,aws-node-1024
aws,node,1024,eu-central-1,2188,2070,118,aws-node-1024
aws,node,1024,eu-central-1,2212,2088,124,aws-node-1024
aws,node,1024,eu-central-1,2169,2067,102,aws-node-1024
aws,node,1024,eu-central-1,2206,2087,119,aws-node-1024
aws,node,1024,eu-central-1,2183,2064,119,aws-node-1024
aws,node,1024,eu-central-1,2203,2088,115,aws-node-1024
aws,node,1024,eu-central-1,2170,2063,107,aws-node-1024
aws,node,1024,eu-central-1,2651,2096,555,aws-node-1024
aws,node,1024,eu-central-1,2177,2066,111,aws-node-1024
aws,node,1024,eu-central-1,2214,2089,125,aws-node-1024
aws,node,1024,eu-central-1,2176,2061,115,aws-node-1024
aws,node,1024,eu-central-1,2517,2080,437,aws-node-1024
aws,node,1024,eu-central-1,2603,2068,535,aws-node-1024
aws,node,1024,eu-central-1,2304,2086,218,aws-node-1024
aws,node,1024,eu-central-1,2178,2065,113,aws-node-1024
aws,node,1024,eu-central-1,2314,2088,226,aws-node-1024
aws,node,1024,eu-central-1,2346,2069,277,aws-node-1024
aws,node,1024,eu-central-1,2344,2051,293,aws-node-1024
aws,node,1024,eu-central-1,2206,2090,116,aws-node-1024
aws,node,2048,eu-central-1,1224,1132,92,aws-node-2048
aws,node,2048,eu-central-1,1253,1127,126,aws-node-2048
aws,node,2048,eu-central-1,1243,1144,99,aws-node-2048
aws,node,2048,eu-central-1,1195,1124,71,aws-node-2048
aws,node,2048,eu-central-1,1239,1132,107,aws-node-2048
aws,node,2048,eu-central-1,1228,1147,81,aws-node-2048
aws,node,2048,eu-central-1,1179,1120,59,aws-node-2048
aws,node,2048,eu-central-1,1198,1119,79,aws-node-2048
aws,node,2048,eu-central-1,1199,1122,77,aws-node-2048
aws,node,2048,eu-central-1,1233,1166,67,aws-node-2048
aws,node,2048,eu-central-1,1235,1124,111,aws-node-2048
aws,node,2048,eu-central-1,1202,1135,67,aws-node-2048
aws,node,2048,eu-central-1,1265,1169,96,aws-node-2048
aws,node,2048,eu-central-1,1206,1132,74,aws-node-2048
aws,node,2048,eu-central-1,1239,1163,76,aws-node-2048
aws,node,2048,eu-central-1,1215,1137,78,aws-node-2048
aws,node,2048,eu-central-1,1241,1124,117,aws-node-2048
aws,node,2048,eu-central-1,1195,1124,71,aws-node-2048
aws,node,2048,eu-central-1,1202,1130,72,aws-node-2048
aws,node,2048,eu-central-1,1214,1131,83,aws-node-2048
aws,node,2048,eu-central-1,1237,1145,92,aws-node-2048
aws,node,2048,eu-central-1,1189,1133,56,aws-node-2048
aws,node,2048,eu-central-1,1197,1125,72,aws-node-2048
aws,node,2048,eu-central-1,1182,1124,58,aws-node-2048
aws,node,2048,eu-central-1,1210,1130,80,aws-node-2048
aws,node,2048,eu-central-1,1214,1141,73,aws-node-2048
aws,node,2048,eu-central-1,1195,1124,71,aws-node-2048
aws,node,2048,eu-central-1,1230,1125,105,aws-node-2048
aws,node,2048,eu-central-1,1211,1153,58,aws-node-2048
aws,node,2048,eu-central-1,1190,1116,74,aws-node-2048
aws,node,2048,eu-central-1,1238,1123,115,aws-node-2048
aws,node,2048,eu-central-1,1259,1146,113,aws-node-2048
aws,node,2048,eu-central-1,1228,1144,84,aws-node-2048
aws,node,2048,eu-central-1,1271,1195,76,aws-node-2048
aws,node,2048,eu-central-1,1229,1124,105,aws-node-2048
aws,node,2048,eu-central-1,1214,1141,73,aws-node-2048
aws,node,2048,eu-central-1,1216,1142,74,aws-node-2048
aws,node,2048,eu-central-1,1193,1127,66,aws-node-2048
aws,node,2048,eu-central-1,1206,1137,69,aws-node-2048
aws,node,2048,eu-central-1,1216,1135,81,aws-node-2048
aws,node,2048,eu-central-1,1204,1139,65,aws-node-2048
aws,node,2048,eu-central-1,1187,1128,59,aws-node-2048
aws,node,2048,eu-central-1,1179,1125,54,aws-node-2048
aws,node,2048,eu-central-1,1257,1135,122,aws-node-2048
aws,node,2048,eu-central-1,1197,1123,74,aws-node-2048
aws,node,2048,eu-central-1,1217,1138,79,aws-node-2048
aws,node,2048,eu-central-1,1183,1126,57,aws-node-2048
aws,node,2048,eu-central-1,1255,1136,119,aws-node-2048
aws,node,2048,eu-central-1,1191,1120,71,aws-node-2048
aws,node,2048,eu-central-1,1221,1131,90,aws-node-2048
aws,node,2048,eu-central-1,1192,1135,57,aws-node-2048
aws,node,2048,eu-central-1,1564,1130,434,aws-node-2048
aws,node,2048,eu-central-1,1255,1139,116,aws-node-2048
aws,node,2048,eu-central-1,1202,1124,78,aws-node-2048
aws,node,2048,eu-central-1,1196,1135,61,aws-node-2048
aws,node,2048,eu-central-1,1197,1136,61,aws-node-2048
aws,node,2048,eu-central-1,1224,1131,93,aws-node-2048
aws,node,2048,eu-central-1,1194,1138,56,aws-node-2048
aws,node,2048,eu-central-1,1193,1126,67,aws-node-2048
aws,node,2048,eu-central-1,1192,1137,55,aws-node-2048
aws,node,2048,eu-central-1,1197,1125,72,aws-node-2048
aws,node,2048,eu-central-1,1711,1150,561,aws-node-2048
aws,node,2048,eu-central-1,1196,1131,65,aws-node-2048
aws,node,2048,eu-central-1,1215,1136,79,aws-node-2048
aws,node,2048,eu-central-1,1196,1126,70,aws-node-2048
aws,node,2048,eu-central-1,1196,1132,64,aws-node-2048
aws,node,2048,eu-central-1,1218,1149,69,aws-node-2048
aws,node,2048,eu-central-1,1210,1137,73,aws-node-2048
aws,node,2048,eu-central-1,1198,1125,73,aws-node-2048
aws,node,2048,eu-central-1,1211,1134,77,aws-node-2048
aws,node,2048,eu-central-1,1256,1143,113,aws-node-2048
aws,node,2048,eu-central-1,1208,1133,75,aws-node-2048
aws,node,2048,eu-central-1,1240,1128,112,aws-node-2048
aws,node,2048,eu-central-1,1216,1139,77,aws-node-2048
aws,node,2048,eu-central-1,1225,1125,100,aws-node-2048
aws,node,2048,eu-central-1,1215,1138,77,aws-node-2048
aws,node,2048,eu-central-1,1190,1122,68,aws-node-2048
aws,node,2048,eu-central-1,1197,1135,62,aws-node-2048
aws,node,2048,eu-central-1,1196,1140,56,aws-node-2048
aws,node,2048,eu-central-1,1189,1134,55,aws-node-2048
aws,node,2048,eu-central-1,1198,1121,77,aws-node-2048
aws,node,2048,eu-central-1,1206,1133,73,aws-node-2048
aws,node,2048,eu-central-1,1188,1118,70,aws-node-2048
aws,node,2048,eu-central-1,1227,1171,56,aws-node-2048
aws,node,2048,eu-central-1,1227,1147,80,aws-node-2048
aws,node,2048,eu-central-1,1193,1135,58,aws-node-2048
aws,node,2048,eu-central-1,1192,1120,72,aws-node-2048
aws,node,2048,eu-central-1,1245,1133,112,aws-node-2048
aws,node,2048,eu-central-1,1233,1145,88,aws-node-2048
aws,node,2048,eu-central-1,1198,1127,71,aws-node-2048
aws,node,2048,eu-central-1,1194,1127,67,aws-node-2048
aws,node,2048,eu-central-1,1182,1113,69,aws-node-2048
aws,node,2048,eu-central-1,1207,1131,76,aws-node-2048
aws,node,2048,eu-central-1,1195,1122,73,aws-node-2048
aws,node,2048,eu-central-1,1229,1163,66,aws-node-2048
aws,node,2048,eu-central-1,1226,1144,82,aws-node-2048
aws,node,2048,eu-central-1,1248,1130,118,aws-node-2048
aws,node,2048,eu-central-1,1211,1146,65,aws-node-2048
aws,node,2048,eu-central-1,1213,1144,69,aws-node-2048
aws,node,2048,eu-central-1,1256,1151,105,aws-node-2048
aws,python,128,eu-central-1,8287,8040,247,aws-python-128
aws,python,128,eu-central-1,8248,7887,361,aws-python-128
aws,python,128,eu-central-1,8051,7904,147,aws-python-128
aws,python,128,eu-central-1,8004,7827,177,aws-python-128
aws,python,128,eu-central-1,8064,7892,172,aws-python-128
aws,python,128,eu-central-1,8082,7912,170,aws-python-128
aws,python,128,eu-central-1,8103,7921,182,aws-python-128
aws,python,128,eu-central-1,8039,7868,171,aws-python-128
aws,python,128,eu-central-1,8093,7939,154,aws-python-128
aws,python,128,eu-central-1,8125,7896,229,aws-python-128
aws,python,128,eu-central-1,8054,7912,142,aws-python-128
aws,python,128,eu-central-1,8068,7896,172,aws-python-128
aws,python,128,eu-central-1,8072,7937,135,aws-python-128
aws,python,128,eu-central-1,8041,7899,142,aws-python-128
aws,python,128,eu-central-1,8068,7919,149,aws-python-128
aws,python,128,eu-central-1,8083,7919,164,aws-python-128
aws,python,128,eu-central-1,8082,7925,157,aws-python-128
aws,python,128,eu-central-1,8075,7883,192,aws-python-128
aws,python,128,eu-central-1,8058,7922,136,aws-python-128
aws,python,128,eu-central-1,7989,7823,166,aws-python-128
aws,python,128,eu-central-1,8032,7907,125,aws-python-128
aws,python,128,eu-central-1,7995,7857,138,aws-python-128
aws,python,128,eu-central-1,8078,7938,140,aws-python-128
aws,python,128,eu-central-1,8025,7852,173,aws-python-128
aws,python,128,eu-central-1,8073,7931,142,aws-python-128
aws,python,128,eu-central-1,8049,7911,138,aws-python-128
aws,python,128,eu-central-1,8102,7943,159,aws-python-128
aws,python,128,eu-central-1,8045,7868,177,aws-python-128
aws,python,128,eu-central-1,8069,7903,166,aws-python-128
aws,python,128,eu-central-1,8023,7869,154,aws-python-128
aws,python,128,eu-central-1,8075,7945,130,aws-python-128
aws,python,128,eu-central-1,8051,7889,162,aws-python-128
aws,python,128,eu-central-1,8142,7922,220,aws-python-128
aws,python,128,eu-central-1,8034,7918,116,aws-python-128
aws,python,128,eu-central-1,8094,7932,162,aws-python-128
aws,python,128,eu-central-1,8246,7844,402,aws-python-128
aws,python,128,eu-central-1,8032,7907,125,aws-python-128
aws,python,128,eu-central-1,8145,7908,237,aws-python-128
aws,python,128,eu-central-1,8128,7965,163,aws-python-128
aws,python,128,eu-central-1,8077,7898,179,aws-python-128
aws,python,128,eu-central-1,8069,7945,124,aws-python-128
aws,python,128,eu-central-1,8001,7864,137,aws-python-128
aws,python,128,eu-central-1,8064,7926,138,aws-python-128
aws,python,128,eu-central-1,8043,7909,134,aws-python-128
aws,python,128,eu-central-1,8079,7930,149,aws-python-128
aws,python,128,eu-central-1,8149,7859,290,aws-python-128
aws,python,128,eu-central-1,8159,8007,152,aws-python-128
aws,python,128,eu-central-1,8081,7892,189,aws-python-128
aws,python,128,eu-central-1,8095,7939,156,aws-python-128
aws,python,128,eu-central-1,8029,7861,168,aws-python-128
aws,python,128,eu-central-1,8220,7963,257,aws-python-128
aws,python,128,eu-central-1,8052,7862,190,aws-python-128
aws,python,128,eu-central-1,8095,7889,206,aws-python-128
aws,python,128,eu-central-1,8010,7849,161,aws-python-128
aws,python,128,eu-central-1,8091,7922,169,aws-python-128
aws,python,128,eu-central-1,8185,7904,281,aws-python-128
aws,python,128,eu-central-1,8084,7919,165,aws-python-128
aws,python,128,eu-central-1,8115,7887,228,aws-python-128
aws,python,128,eu-central-1,8084,7923,161,aws-python-128
aws,python,128,eu-central-1,8037,7877,160,aws-python-128
aws,python,128,eu-central-1,8139,7963,176,aws-python-128
aws,python,128,eu-central-1,8050,7902,148,aws-python-128
aws,python,128,eu-central-1,8094,7940,154,aws-python-128
aws,python,128,eu-central-1,8050,7875,175,aws-python-128
aws,python,128,eu-central-1,8096,7933,163,aws-python-128
aws,python,128,eu-central-1,8047,7881,166,aws-python-128
aws,python,128,eu-central-1,8091,7943,148,aws-python-128
aws,python,128,eu-central-1,8031,7872,159,aws-python-128
aws,python,128,eu-central-1,8127,7964,163,aws-python-128
aws,python,128,eu-central-1,7985,7850,135,aws-python-128
aws,python,128,eu-central-1,8153,7977,176,aws-python-128
aws,python,128,eu-central-1,8044,7879,165,aws-python-128
aws,python,128,eu-central-1,8093,7877,216,aws-python-128
aws,python,128,eu-central-1,8063,7920,143,aws-python-128
aws,python,128,eu-central-1,8142,7966,176,aws-python-128
aws,python,128,eu-central-1,8019,7867,152,aws-python-128
aws,python,128,eu-central-1,8131,7978,153,aws-python-128
aws,python,128,eu-central-1,7994,7809,185,aws-python-128
aws,python,128,eu-central-1,8218,7904,314,aws-python-128
aws,python,128,eu-central-1,8019,7856,163,aws-python-128
aws,python,128,eu-central-1,8496,7992,504,aws-python-128
aws,python,128,eu-central-1,8070,7850,220,aws-python-128
aws,python,128,eu-central-1,8092,7956,136,aws-python-128
aws,python,128,eu-central-1,8020,7855,165,aws-python-128
aws,python,128,eu-central-1,8066,7887,179,aws-python-128
aws,python,128,eu-central-1,8037,7917,120,aws-python-128
aws,python,128,eu-central-1,8086,7898,188,aws-python-128
aws,python,128,eu-central-1,7977,7817,160,aws-python-128
aws,python,128,eu-central-1,8082,7924,158,aws-python-128
aws,python,128,eu-central-1,8031,7870,161,aws-python-128
aws,python,128,eu-central-1,8042,7886,156,aws-python-128
aws,python,128,eu-central-1,8038,7863,175,aws-python-128
aws,python,128,eu-central-1,8055,7869,186,aws-python-128
aws,python,128,eu-central-1,8045,7865,180,aws-python-128
aws,python,128,eu-central-1,8135,7946,189,aws-python-128
aws,python,128,eu-central-1,7998,7857,141,aws-python-128
aws,python,128,eu-central-1,8027,7905,122,aws-python-128
aws,python,128,eu-central-1,8079,7898,181,aws-python-128
aws,python,128,eu-central-1,8101,7905,196,aws-python-128
aws,python,128,eu-central-1,8041,7868,173,aws-python-128
aws,python,256,eu-central-1,4073,3911,162,aws-python-256
aws,python,256,eu-central-1,4038,3902,136,aws-python-256
aws,python,256,eu-central-1,4036,3933,103,aws-python-256
aws,python,256,eu-central-1,4032,3914,118,aws-python-256
aws,python,256,eu-central-1,4127,4015,112,aws-python-256
aws,python,256,eu-central-1,4046,3938,108,aws-python-256
aws,python,256,eu-central-1,4045,3941,104,aws-python-256
aws,python,256,eu-central-1,4087,3945,142,aws-python-256
aws,python,256,eu-central-1,4066,3927,139,aws-python-256
aws,python,256,eu-central-1,4136,4005,131,aws-python-256
aws,python,256,eu-central-1,4059,3920,139,aws-python-256
aws,python,256,eu-central-1,4059,3926,133,aws-python-256
aws,python,256,eu-central-1,4038,3941,97,aws-python-256
aws,python,256,eu-central-1,4056,3928,128,aws-python-256
aws,python,256,eu-central-1,4121,4014,107,aws-python-256
aws,python,256,eu-central-1,4056,3903,153,aws-python-256
aws,python,256,eu-central-1,4349,3924,425,aws-python-256
aws,python,256,eu-central-1,4381,3913,468,aws-python-256
aws,python,256,eu-central-1,4042,3920,122,aws-python-256
aws,python,256,eu-central-1,4099,3964,135,aws-python-256
aws,python,256,eu-central-1,4054,3939,115,aws-python-256
aws,python,256,eu-central-1,4048,3904,144,aws-python-256
aws,python,256,eu-central-1,4051,3918,133,aws-python-256
aws,python,256,eu-central-1,4044,3899,145,aws-python-256
aws,python,256,eu-central-1,4100,3967,133,aws-python-256
aws,python,256,eu-central-1,4083,3940,143,aws-python-256
aws,python,256,eu-central-1,4062,3955,107,aws-python-256
aws,python,256,eu-central-1,4058,3914,144,aws-python-256
aws,python,256,eu-central-1,4060,3930,130,aws-python-256
aws,python,256,eu-central-1,4121,3990,131,aws-python-256
aws,python,256,eu-central-1,4037,3913,124,aws-python-256
aws,python,256,eu-central-1,4058,3926,132,aws-python-256
aws,python,256,eu-central-1,4031,3916,115,aws-python-256
aws,python,256,eu-central-1,4032,3910,122,aws-python-256
aws,python,256,eu-central-1,4088,3971,117,aws-python-256
aws,python,256,eu-central-1,4031,3911,120,aws-python-256
aws,python,256,eu-central-1,4447,3920,527,aws-python-256
aws,python,256,eu-central-1,4045,3931,114,aws-python-256
aws,python,256,eu-central-1,4104,3948,156,aws-python-256
aws,python,256,eu-central-1,4107,3989,118,aws-python-256
aws,python,256,eu-central-1,4049,3935,114,aws-python-256
aws,python,256,eu-central-1,4077,3914,163,aws-python-256
aws,python,256,eu-central-1,4029,3908,121,aws-python-256
aws,python,256,eu-central-1,4044,3910,134,aws-python-256
aws,python,256,eu-central-1,4082,3946,136,aws-python-256
aws,python,256,eu-central-1,4044,3933,111,aws-python-256
aws,python,256,eu-central-1,4040,3901,139,aws-python-256
aws,python,256,eu-central-1,4042,3924,118,aws-python-256
aws,python,256,eu-central-1,4035,3917,118,aws-python-256
aws,python,256,eu-central-1,4094,3962,132,aws-python-256
aws,python,256,eu-central-1,4037,3919,118,aws-python-256
aws,python,256,eu-central-1,4051,3921,130,aws-python-256
aws,python,256,eu-central-1,4028,3906,122,aws-python-256
aws,python,256,eu-central-1,4035,3911,124,aws-python-256
aws,python,256,eu-central-1,4110,3988,122,aws-python-256
aws,python,256,eu-central-1,4031,3903,128,aws-python-256
aws,python,256,eu-central-1,4080,3932,148,aws-python-256
aws,python,256,eu-central-1,4033,3908,125,aws-python-256
aws,python,256,eu-central-1,4035,3933,102,aws-python-256
aws,python,256,eu-central-1,4100,3998,102,aws-python-256
aws,python,256,eu-central-1,4058,3939,119,aws-python-256
aws,python,256,eu-central-1,4069,3930,139,aws-python-256
aws,python,256,eu-central-1,4058,3944,114,aws-python-256
aws,python,256,eu-central-1,4041,3922,119,aws-python-256
aws,python,256,eu-central-1,4081,3936,145,aws-python-256
aws,python,256,eu-central-1,4038,3927,111,aws-python-256
aws,python,256,eu-central-1,4035,3923,112,aws-python-256
aws,python,256,eu-central-1,4053,3922,131,aws-python-256
aws,python,256,eu-central-1,4054,3929,125,aws-python-256
aws,python,256,eu-central-1,4136,4004,132,aws-python-256
aws,python,256,eu-central-1,4027,3912,115,aws-python-256
aws,python,256,eu-central-1,4052,3929,123,aws-python-256
aws,python,256,eu-central-1,4063,3928,135,aws-python-256
aws,python,256,eu-central-1,4082,3938,144,aws-python-256
aws,python,256,eu-central-1,4089,3983,106,aws-python-256
aws,python,256,eu-central-1,4044,3926,118,aws-python-256
aws,python,256,eu-central-1,4063,3955,108,aws-python-256
aws,python,256,eu-central-1,4038,3923,115,aws-python-256
aws,python,256,eu-central-1,4130,3904,226,aws-python-256
aws,python,256,eu-central-1,4124,3979,145,aws-python-256
aws,python,256,eu-central-1,4087,3959,128,aws-python-256
aws,python,256,eu-central-1,4058,3928,130,aws-python-256
aws,python,256,eu-central-1,4052,3935,117,aws-python-256
aws,python,256,eu-central-1,4052,3941,111,aws-python-256
aws,python,256,eu-central-1,4107,3966,141,aws-python-256
aws,python,256,eu-central-1,4043,3915,128,aws-python-256
aws,python,256,eu-central-1,4050,3931,119,aws-python-256
aws,python,256,eu-central-1,4046,3890,156,aws-python-256
aws,python,256,eu-central-1,4072,3904,168,aws-python-256
aws,python,256,eu-central-1,4128,3990,138,aws-python-256
aws,python,256,eu-central-1,4053,3921,132,aws-python-256
aws,python,256,eu-central-1,4043,3910,133,aws-python-256
aws,python,256,eu-central-1,4019,3896,123,aws-python-256
aws,python,256,eu-central-1,4041,3938,103,aws-python-256
aws,python,256,eu-central-1,4095,3976,119,aws-python-256
aws,python,256,eu-central-1,4040,3917,123,aws-python-256
aws,python,256,eu-central-1,4042,3938,104,aws-python-256
aws,python,256,eu-central-1,4071,3918,153,aws-python-256
aws,python,256,eu-central-1,4150,3919,231,aws-python-256
aws,python,256,eu-central-1,4124,4017,107,aws-python-256
aws,python,512,eu-central-1,2121,1970,151,aws-python-512
aws,python,512,eu-central-1,2080,1965,115,aws-python-512
aws,python,512,eu-central-1,2078,1954,124,aws-python-512
aws,python,512,eu-central-1,2075,1940,135,aws-python-512
aws,python,512,eu-central-1,2150,1949,201,aws-python-512
aws,python,512,eu-central-1,2069,1941,128,aws-python-512
aws,python,512,eu-central-1,2056,1945,111,aws-python-512
aws,python,512,eu-central-1,2074,1945,129,aws-python-512
aws,python,512,eu-central-1,2379,1940,439,aws-python-512
aws,python,512,eu-central-1,2075,1956,119,aws-python-512
aws,python,512,eu-central-1,2199,1939,260,aws-python-512
aws,python,512,eu-central-1,2072,1940,132,aws-python-512
aws,python,512,eu-central-1,2068,1931,137,aws-python-512
aws,python,512,eu-central-1,2068,1948,120,aws-python-512
aws,python,512,eu-central-1,2068,1945,123,aws-python-512
aws,python,512,eu-central-1,2411,1947,464,aws-python-512
aws,python,512,eu-central-1,2062,1958,104,aws-python-512
aws,python,512,eu-central-1,2083,1947,136,aws-python-512
aws,python,512,eu-central-1,2093,1954,139,aws-python-512
aws,python,512,eu-central-1,2066,1950,116,aws-python-512
aws,python,512,eu-central-1,2050,1933,117,aws-python-512
aws,python,512,eu-central-1,2075,1942,133,aws-python-512
aws,python,512,eu-central-1,2062,1938,124,aws-python-512
aws,python,512,eu-central-1,2101,1949,152,aws-python-512
aws,python,512,eu-central-1,2074,1947,127,aws-python-512
aws,python,512,eu-central-1,2073,1932,141,aws-python-512
aws,python,512,eu-central-1,2070,1955,115,aws-python-512
aws,python,512,eu-central-1,2094,1973,121,aws-python-512
aws,python,512,eu-central-1,2067,1946,121,aws-python-512
aws,python,512,eu-central-1,2069,1960,109,aws-python-512
aws,python,512,eu-central-1,2069,1940,129,aws-python-512
aws,python,512,eu-central-1,2068,1933,135,aws-python-512
aws,python,512,eu-central-1,2097,1947,150,aws-python-512
aws,python,512,eu-central-1,2081,1939,142,aws-python-512
aws,python,512,eu-central-1,2080,1947,133,aws-python-512
aws,python,512,eu-central-1,2066,1952,114,aws-python-512
aws,python,512,eu-central-1,2079,1957,122,aws-python-512
aws,python,512,eu-central-1,2077,1962,115,aws-python-512
aws,python,512,eu-central-1,2078,1944,134,aws-python-512
aws,python,512,eu-central-1,2075,1960,115,aws-python-512
aws,python,512,eu-central-1,2075,1960,115,aws-python-512
aws,python,512,eu-central-1,2074,1961,113,aws-python-512
aws,python,512,eu-central-1,2069,1942,127,aws-python-512
aws,python,512,eu-central-1,2069,1956,113,aws-python-512
aws,python,512,eu-central-1,2072,1955,117,aws-python-512
aws,python,512,eu-central-1,2071,1946,125,aws-python-512
aws,python,512,eu-central-1,2082,1950,132,aws-python-512
aws,python,512,eu-central-1,2084,1948,136,aws-python-512
aws,python,512,eu-central-1,2066,1940,126,aws-python-512
aws,python,512,eu-central-1,2067,1959,108,aws-python-512
aws,python,512,eu-central-1,2061,1946,115,aws-python-512
aws,python,512,eu-central-1,2043,1947,96,aws-python-512
aws,python,512,eu-central-1,2218,1952,266,aws-python-512
aws,python,512,eu-central-1,2062,1944,118,aws-python-512
aws,python,512,eu-central-1,2062,1947,115,aws-python-512
aws,python,512,eu-central-1,2061,1959,102,aws-python-512
aws,python,512,eu-central-1,2064,1946,118,aws-python-512
aws,python,512,eu-central-1,2080,1945,135,aws-python-512
aws,python,512,eu-central-1,2079,1951,128,aws-python-512
aws,python,512,eu-central-1,2113,1946,167,aws-python-512
aws,python,512,eu-central-1,2057,1947,110,aws-python-512
aws,python,512,eu-central-1,2492,1955,537,aws-python-512
aws,python,512,eu-central-1,2062,1937,125,aws-python-512
aws,python,512,eu-central-1,2085,1959,126,aws-python-512
aws,python,512,eu-central-1,2378,1960,418,aws-python-512
aws,python,512,eu-central-1,2074,1943,131,aws-python-512
aws,python,512,eu-central-1,2103,1944,159,aws-python-512
aws,python,512,eu-central-1,2061,1936,125,aws-python-512
aws,python,512,eu-central-1,2074,1942,132,aws-python-512
aws,python,512,eu-central-1,2062,1940,122,aws-python-512
aws,python,512,eu-central-1,2065,1955,110,aws-python-512
aws,python,512,eu-central-1,2070,1935,135,aws-python-512
aws,python,512,eu-central-1,2277,1959,318,aws-python-512
aws,python,512,eu-central-1,2078,1940,138,aws-python-512
aws,python,512,eu-central-1,2054,1942,112,aws-python-512
aws,python,512,eu-central-1,2066,1929,137,aws-python-512
aws,python,512,eu-central-1,2076,1958,118,aws-python-512
aws,python,512,eu-central-1,2051,1955,96,aws-python-512
aws,python,512,eu-central-1,2495,1942,553,aws-python-512
aws,python,512,eu-central-1,2059,1953,106,aws-python-512
aws,python,512,eu-central-1,2064,1955,109,aws-python-512
aws,python,512,eu-central-1,2067,1933,134,aws-python-512
aws,python,512,eu-central-1,2087,1947,140,aws-python-512
aws,python,512,eu-central-1,2006,1950,56,aws-python-512
aws,python,512,eu-central-1,2063,1935,128,aws-python-512
aws,python,512,eu-central-1,2062,1948,114,aws-python-512
aws,python,512,eu-central-1,2066,1951,115,aws-python-512
aws,python,512,eu-central-1,2066,1959,107,aws-python-512
aws,python,512,eu-central-1,2047,1948,99,aws-python-512
aws,python,512,eu-central-1,2065,1948,117,aws-python-512
aws,python,512,eu-central-1,2061,1949,112,aws-python-512
aws,python,512,eu-central-1,2260,1944,316,aws-python-512
aws,python,512,eu-central-1,2064,1948,116,aws-python-512
aws,python,512,eu-central-1,2041,1946,95,aws-python-512
aws,python,512,eu-central-1,2259,1960,299,aws-python-512
aws,python,512,eu-central-1,2058,1933,125,aws-python-512
aws,python,512,eu-central-1,2061,1934,127,aws-python-512
aws,python,512,eu-central-1,2075,1944,131,aws-python-512
aws,python,512,eu-central-1,2039,1915,124,aws-python-512
aws,python,512,eu-central-1,2286,1959,327,aws-python-512
aws,python,1024,eu-central-1,1341,992,349,aws-python-1024
aws,python,1024,eu-central-1,1073,1007,66,aws-python-1024
aws,python,1024,eu-central-1,1071,1000,71,aws-python-1024
aws,python,1024,eu-central-1,1064,997,67,aws-python-1024
aws,python,1024,eu-central-1,1066,1002,64,aws-python-1024
aws,python,1024,eu-central-1,1071,997,74,aws-python-1024
aws,python,1024,eu-central-1,1079,1009,70,aws-python-1024
aws,python,1024,eu-central-1,1070,1003,67,aws-python-1024
aws,python,1024,eu-central-1,1061,992,69,aws-python-1024
aws,python,1024,eu-central-1,1074,981,93,aws-python-1024
aws,python,1024,eu-central-1,1077,1010,67,aws-python-1024
aws,python,1024,eu-central-1,1153,994,159,aws-python-1024
aws,python,1024,eu-central-1,1090,1013,77,aws-python-1024
aws,python,1024,eu-central-1,1092,1001,91,aws-python-1024
aws,python,1024,eu-central-1,1075,999,76,aws-python-1024
aws,python,1024,eu-central-1,1061,1001,60,aws-python-1024
aws,python,1024,eu-central-1,1078,997,81,aws-python-1024
aws,python,1024,eu-central-1,1103,1001,102,aws-python-1024
aws,python,1024,eu-central-1,1058,994,64,aws-python-1024
aws,python,1024,eu-central-1,1108,1005,103,aws-python-1024
aws,python,1024,eu-central-1,1078,1002,76,aws-python-1024
aws,python,1024,eu-central-1,1055,996,59,aws-python-1024
aws,python,1024,eu-central-1,1048,998,50,aws-python-1024
aws,python,1024,eu-central-1,1070,999,71,aws-python-1024
aws,python,1024,eu-central-1,1071,998,73,aws-python-1024
aws,python,1024,eu-central-1,1081,1001,80,aws-python-1024
aws,python,1024,eu-central-1,1085,1000,85,aws-python-1024
aws,python,1024,eu-central-1,1084,1001,83,aws-python-1024
aws,python,1024,eu-central-1,1106,1008,98,aws-python-1024
aws,python,1024,eu-central-1,1067,1003,64,aws-python-1024
aws,python,1024,eu-central-1,1063,1002,61,aws-python-1024
aws,python,1024,eu-central-1,1086,1010,76,aws-python-1024
aws,python,1024,eu-central-1,1058,996,62,aws-python-1024
aws,python,1024,eu-central-1,1057,993,64,aws-python-1024
aws,python,1024,eu-central-1,1059,997,62,aws-python-1024
aws,python,1024,eu-central-1,1071,997,74,aws-python-1024
aws,python,1024,eu-central-1,1074,1002,72,aws-python-1024
aws,python,1024,eu-central-1,1062,1008,54,aws-python-1024
aws,python,1024,eu-central-1,1065,999,66,aws-python-1024
aws,python,1024,eu-central-1,1076,1006,70,aws-python-1024
aws,python,1024,eu-central-1,1064,1003,61,aws-python-1024
aws,python,1024,eu-central-1,1550,1004,546,aws-python-1024
aws,python,1024,eu-central-1,1075,1003,72,aws-python-1024
aws,python,1024,eu-central-1,1055,993,62,aws-python-1024
aws,python,1024,eu-central-1,1070,998,72,aws-python-1024
aws,python,1024,eu-central-1,1066,993,73,aws-python-1024
aws,python,1024,eu-central-1,1072,990,82,aws-python-1024
aws,python,1024,eu-central-1,1051,994,57,aws-python-1024
aws,python,1024,eu-central-1,1072,1005,67,aws-python-1024
aws,python,1024,eu-central-1,1066,1009,57,aws-python-1024
aws,python,1024,eu-central-1,1310,1008,302,aws-python-1024
aws,python,1024,eu-central-1,1066,999,67,aws-python-1024
aws,python,1024,eu-central-1,1298,999,299,aws-python-1024
aws,python,1024,eu-central-1,1066,999,67,aws-python-1024
aws,python,1024,eu-central-1,1081,996,85,aws-python-1024
aws,python,1024,eu-central-1,1061,1001,60,aws-python-1024
aws,python,1024,eu-central-1,1080,1003,77,aws-python-1024
aws,python,1024,eu-central-1,1077,997,80,aws-python-1024
aws,python,1024,eu-central-1,1057,992,65,aws-python-1024
aws,python,1024,eu-central-1,1065,992,73,aws-python-1024
aws,python,1024,eu-central-1,1075,991,84,aws-python-1024
aws,python,1024,eu-central-1,1056,989,67,aws-python-1024
aws,python,1024,eu-central-1,1050,981,69,aws-python-1024
aws,python,1024,eu-central-1,1073,996,77,aws-python-1024
aws,python,1024,eu-central-1,1055,994,61,aws-python-1024
aws,python,1024,eu-central-1,1069,997,72,aws-python-1024
aws,python,1024,eu-central-1,1070,1000,70,aws-python-1024
aws,python,1024,eu-central-1,1066,997,69,aws-python-1024
aws,python,1024,eu-central-1,1085,1007,78,aws-python-1024
aws,python,1024,eu-central-1,1082,1003,79,aws-python-1024
aws,python,1024,eu-central-1,1405,1000,405,aws-python-1024
aws,python,1024,eu-central-1,1086,1020,66,aws-python-1024
aws,python,1024,eu-central-1,1540,995,545,aws-python-1024
aws,python,1024,eu-central-1,1084,1006,78,aws-python-1024
aws,python,1024,eu-central-1,1057,997,60,aws-python-1024
aws,python,1024,eu-central-1,1082,1007,75,aws-python-1024
aws,python,1024,eu-central-1,1076,1006,70,aws-python-1024
aws,python,1024,eu-central-1,1055,992,63,aws-python-1024
aws,python,1024,eu-central-1,1075,998,77,aws-python-1024
aws,python,1024,eu-central-1,1075,1016,59,aws-python-1024
aws,python,1024,eu-central-1,1073,997,76,aws-python-1024
aws,python,1024,eu-central-1,1075,1010,65,aws-python-1024
aws,python,1024,eu-central-1,1069,1003,66,aws-python-1024
aws,python,1024,eu-central-1,1093,1015,78,aws-python-1024
aws,python,1024,eu-central-1,1069,1009,60,aws-python-1024
aws,python,1024,eu-central-1,1088,996,92,aws-python-1024
aws,python,1024,eu-central-1,1068,995,73,aws-python-1024
aws,python,1024,eu-central-1,1069,993,76,aws-python-1024
aws,python,1024,eu-central-1,1173,992,181,aws-python-1024
aws,python,1024,eu-central-1,1064,991,73,aws-python-1024
aws,python,1024,eu-central-1,1093,1009,84,aws-python-1024
aws,python,1024,eu-central-1,1065,1002,63,aws-python-1024
aws,python,1024,eu-central-1,1062,1005,57,aws-python-1024
aws,python,1024,eu-central-1,1066,999,67,aws-python-1024
aws,python,1024,eu-central-1,1072,1010,62,aws-python-1024
aws,python,1024,eu-central-1,1063,1005,58,aws-python-1024
aws,python,1024,eu-central-1,1076,992,84,aws-python-1024
aws,python,1024,eu-central-1,1251,1002,249,aws-python-1024
aws,python,1024,eu-central-1,1078,1002,76,aws-python-1024
aws,python,1024,eu-central-1,1078,1008,70,aws-python-1024
aws,python,2048,eu-central-1,651,558,93,aws-python-2048
aws,python,2048,eu-central-1,632,571,61,aws-python-2048
aws,python,2048,eu-central-1,637,565,72,aws-python-2048
aws,python,2048,eu-central-1,620,561,59,aws-python-2048
aws,python,2048,eu-central-1,625,558,67,aws-python-2048
aws,python,2048,eu-central-1,645,557,88,aws-python-2048
aws,python,2048,eu-central-1,617,556,61,aws-python-2048
aws,python,2048,eu-central-1,625,555,70,aws-python-2048
aws,python,2048,eu-central-1,626,558,68,aws-python-2048
aws,python,2048,eu-central-1,683,556,127,aws-python-2048
aws,python,2048,eu-central-1,627,556,71,aws-python-2048
aws,python,2048,eu-central-1,636,555,81,aws-python-2048
aws,python,2048,eu-central-1,620,553,67,aws-python-2048
aws,python,2048,eu-central-1,632,557,75,aws-python-2048
aws,python,2048,eu-central-1,640,562,78,aws-python-2048
aws,python,2048,eu-central-1,651,575,76,aws-python-2048
aws,python,2048,eu-central-1,629,557,72,aws-python-2048
aws,python,2048,eu-central-1,645,574,71,aws-python-2048
aws,python,2048,eu-central-1,618,555,63,aws-python-2048
aws,python,2048,eu-central-1,632,557,75,aws-python-2048
aws,python,2048,eu-central-1,646,555,91,aws-python-2048
aws,python,2048,eu-central-1,628,556,72,aws-python-2048
aws,python,2048,eu-central-1,609,552,57,aws-python-2048
aws,python,2048,eu-central-1,633,555,78,aws-python-2048
aws,python,2048,eu-central-1,632,555,77,aws-python-2048
aws,python,2048,eu-central-1,614,554,60,aws-python-2048
aws,python,2048,eu-central-1,615,557,58,aws-python-2048
aws,python,2048,eu-central-1,616,559,57,aws-python-2048
aws,python,2048,eu-central-1,630,556,74,aws-python-2048
aws,python,2048,eu-central-1,628,555,73,aws-python-2048
aws,python,2048,eu-central-1,631,559,72,aws-python-2048
aws,python,2048,eu-central-1,623,557,66,aws-python-2048
aws,python,2048,eu-central-1,626,556,70,aws-python-2048
aws,python,2048,eu-central-1,635,556,79,aws-python-2048
aws,python,2048,eu-central-1,620,554,66,aws-python-2048
aws,python,2048,eu-central-1,620,553,67,aws-python-2048
aws,python,2048,eu-central-1,628,553,75,aws-python-2048
aws,python,2048,eu-central-1,617,553,64,aws-python-2048
aws,python,2048,eu-central-1,629,553,76,aws-python-2048
aws,python,2048,eu-central-1,645,576,69,aws-python-2048
aws,python,2048,eu-central-1,637,557,80,aws-python-2048
aws,python,2048,eu-central-1,626,555,71,aws-python-2048
aws,python,2048,eu-central-1,624,552,72,aws-python-2048
aws,python,2048,eu-central-1,635,550,85,aws-python-2048
aws,python,2048,eu-central-1,632,554,78,aws-python-2048
aws,python,2048,eu-central-1,614,554,60,aws-python-2048
aws,python,2048,eu-central-1,622,551,71,aws-python-2048
aws,python,2048,eu-central-1,631,555,76,aws-python-2048
aws,python,2048,eu-central-1,631,554,77,aws-python-2048
aws,python,2048,eu-central-1,623,556,67,aws-python-2048
aws,python,2048,eu-central-1,952,554,398,aws-python-2048
aws,python,2048,eu-central-1,624,554,70,aws-python-2048
aws,python,2048,eu-central-1,633,569,64,aws-python-2048
aws,python,2048,eu-central-1,640,553,87,aws-python-2048
aws,python,2048,eu-central-1,615,551,64,aws-python-2048
aws,python,2048,eu-central-1,644,570,74,aws-python-2048
aws,python,2048,eu-central-1,683,590,93,aws-python-2048
aws,python,2048,eu-central-1,637,568,69,aws-python-2048
aws,python,2048,eu-central-1,662,574,88,aws-python-2048
aws,python,2048,eu-central-1,642,573,69,aws-python-2048
aws,python,2048,eu-central-1,644,569,75,aws-python-2048
aws,python,2048,eu-central-1,1105,562,543,aws-python-2048
aws,python,2048,eu-central-1,643,573,70,aws-python-2048
aws,python,2048,eu-central-1,657,572,85,aws-python-2048
aws,python,2048,eu-central-1,661,587,74,aws-python-2048
aws,python,2048,eu-central-1,640,571,69,aws-python-2048
aws,python,2048,eu-central-1,627,569,58,aws-python-2048
aws,python,2048,eu-central-1,655,576,79,aws-python-2048
aws,python,2048,eu-central-1,656,571,85,aws-python-2048
aws,python,2048,eu-central-1,664,568,96,aws-python-2048
aws,python,2048,eu-central-1,638,567,71,aws-python-2048
aws,python,2048,eu-central-1,630,571,59,aws-python-2048
aws,python,2048,eu-central-1,640,572,68,aws-python-2048
aws,python,2048,eu-central-1,678,572,106,aws-python-2048
aws,python,2048,eu-central-1,645,574,71,aws-python-2048
aws,python,2048,eu-central-1,671,591,80,aws-python-2048
aws,python,2048,eu-central-1,635,569,66,aws-python-2048
aws,python,2048,eu-central-1,649,573,76,aws-python-2048
aws,python,2048,eu-central-1,639,571,68,aws-python-2048
aws,python,2048,eu-central-1,652,582,70,aws-python-2048
aws,python,2048,eu-central-1,660,565,95,aws-python-2048
aws,python,2048,eu-central-1,653,568,85,aws-python-2048
aws,python,2048,eu-central-1,636,568,68,aws-python-2048
aws,python,2048,eu-central-1,644,584,60,aws-python-2048
aws,python,2048,eu-central-1,650,569,81,aws-python-2048
aws,python,2048,eu-central-1,641,569,72,aws-python-2048
aws,python,2048,eu-central-1,650,573,77,aws-python-2048
aws,python,2048,eu-central-1,643,568,75,aws-python-2048
aws,python,2048,eu-central-1,655,569,86,aws-python-2048
aws,python,2048,eu-central-1,656,572,84,aws-python-2048
aws,python,2048,eu-central-1,623,568,55,aws-python-2048
aws,python,2048,eu-central-1,643,577,66,aws-python-2048
aws,python,2048,eu-central-1,643,585,58,aws-python-2048
aws,python,2048,eu-central-1,654,573,81,aws-python-2048
aws,python,2048,eu-central-1,631,568,63,aws-python-2048
aws,python,2048,eu-central-1,659,572,87,aws-python-2048
aws,python,2048,eu-central-1,656,572,84,aws-python-2048
aws,python,2048,eu-central-1,653,570,83,aws-python-2048
aws,python,2048,eu-central-1,642,572,70,aws-python-2048
aws,python,2048,eu-central-1,649,570,79,aws-python-2048
