cloud,runtime,memory_mb,region,total_ms,measured_ms,latency_ms,name
aws,dotnet,128,eu-central-1,885,716,169,AWS 0128 MB
aws,dotnet,128,eu-central-1,765,670,95,AWS 0128 MB
aws,dotnet,128,eu-central-1,746,663,83,AWS 0128 MB
aws,dotnet,128,eu-central-1,745,663,82,AWS 0128 MB
aws,dotnet,128,eu-central-1,801,702,99,AWS 0128 MB
aws,dotnet,128,eu-central-1,763,682,81,AWS 0128 MB
aws,dotnet,128,eu-central-1,835,683,152,AWS 0128 MB
aws,dotnet,128,eu-central-1,736,662,74,AWS 0128 MB
aws,dotnet,128,eu-central-1,773,684,89,AWS 0128 MB
aws,dotnet,128,eu-central-1,769,679,90,AWS 0128 MB
aws,dotnet,128,eu-central-1,754,687,67,AWS 0128 MB
aws,dotnet,128,eu-central-1,741,663,78,AWS 0128 MB
aws,dotnet,128,eu-central-1,768,705,63,AWS 0128 MB
aws,dotnet,128,eu-central-1,781,642,139,AWS 0128 MB
aws,dotnet,128,eu-central-1,747,654,93,AWS 0128 MB
aws,dotnet,128,eu-central-1,724,646,78,AWS 0128 MB
aws,dotnet,128,eu-central-1,721,643,78,AWS 0128 MB
aws,dotnet,128,eu-central-1,756,666,90,AWS 0128 MB
aws,dotnet,128,eu-central-1,759,671,88,AWS 0128 MB
aws,dotnet,128,eu-central-1,748,675,73,AWS 0128 MB
aws,dotnet,128,eu-central-1,712,654,58,AWS 0128 MB
aws,dotnet,128,eu-central-1,752,698,54,AWS 0128 MB
aws,dotnet,128,eu-central-1,774,679,95,AWS 0128 MB
aws,dotnet,128,eu-central-1,764,678,86,AWS 0128 MB
aws,dotnet,128,eu-central-1,749,687,62,AWS 0128 MB
aws,dotnet,128,eu-central-1,786,691,95,AWS 0128 MB
aws,dotnet,128,eu-central-1,737,643,94,AWS 0128 MB
aws,dotnet,128,eu-central-1,722,646,76,AWS 0128 MB
aws,dotnet,128,eu-central-1,743,675,68,AWS 0128 MB
aws,dotnet,128,eu-central-1,725,647,78,AWS 0128 MB
aws,dotnet,128,eu-central-1,710,642,68,AWS 0128 MB
aws,dotnet,128,eu-central-1,772,691,81,AWS 0128 MB
aws,dotnet,128,eu-central-1,763,674,89,AWS 0128 MB
aws,dotnet,128,eu-central-1,695,631,64,AWS 0128 MB
aws,dotnet,128,eu-central-1,729,647,82,AWS 0128 MB
aws,dotnet,128,eu-central-1,968,659,309,AWS 0128 MB
aws,dotnet,128,eu-central-1,748,670,78,AWS 0128 MB
aws,dotnet,128,eu-central-1,746,658,88,AWS 0128 MB
aws,dotnet,128,eu-central-1,747,651,96,AWS 0128 MB
aws,dotnet,128,eu-central-1,758,675,83,AWS 0128 MB
aws,dotnet,128,eu-central-1,725,666,59,AWS 0128 MB
aws,dotnet,128,eu-central-1,725,643,82,AWS 0128 MB
aws,dotnet,128,eu-central-1,757,699,58,AWS 0128 MB
aws,dotnet,128,eu-central-1,739,671,68,AWS 0128 MB
aws,dotnet,128,eu-central-1,738,658,80,AWS 0128 MB
aws,dotnet,128,eu-central-1,716,658,58,AWS 0128 MB
aws,dotnet,128,eu-central-1,733,667,66,AWS 0128 MB
aws,dotnet,128,eu-central-1,748,686,62,AWS 0128 MB
aws,dotnet,128,eu-central-1,748,666,82,AWS 0128 MB
aws,dotnet,128,eu-central-1,728,662,66,AWS 0128 MB
aws,dotnet,128,eu-central-1,766,666,100,AWS 0128 MB
aws,dotnet,128,eu-central-1,729,659,70,AWS 0128 MB
aws,dotnet,128,eu-central-1,785,684,101,AWS 0128 MB
aws,dotnet,128,eu-central-1,764,634,130,AWS 0128 MB
aws,dotnet,128,eu-central-1,746,674,72,AWS 0128 MB
aws,dotnet,128,eu-central-1,725,655,70,AWS 0128 MB
aws,dotnet,128,eu-central-1,719,659,60,AWS 0128 MB
aws,dotnet,128,eu-central-1,753,686,67,AWS 0128 MB
aws,dotnet,128,eu-central-1,716,643,73,AWS 0128 MB
aws,dotnet,128,eu-central-1,737,662,75,AWS 0128 MB
aws,dotnet,128,eu-central-1,1246,712,534,AWS 0128 MB
aws,dotnet,128,eu-central-1,772,688,84,AWS 0128 MB
aws,dotnet,128,eu-central-1,734,653,81,AWS 0128 MB
aws,dotnet,128,eu-central-1,724,654,70,AWS 0128 MB
aws,dotnet,128,eu-central-1,752,679,73,AWS 0128 MB
aws,dotnet,128,eu-central-1,766,698,68,AWS 0128 MB
aws,dotnet,128,eu-central-1,728,658,70,AWS 0128 MB
aws,dotnet,128,eu-central-1,770,698,72,AWS 0128 MB
aws,dotnet,128,eu-central-1,743,672,71,AWS 0128 MB
aws,dotnet,128,eu-central-1,726,661,65,AWS 0128 MB
aws,dotnet,128,eu-central-1,748,679,69,AWS 0128 MB
aws,dotnet,128,eu-central-1,743,678,65,AWS 0128 MB
aws,dotnet,128,eu-central-1,766,697,69,AWS 0128 MB
aws,dotnet,128,eu-central-1,755,679,76,AWS 0128 MB
aws,dotnet,128,eu-central-1,760,674,86,AWS 0128 MB
aws,dotnet,128,eu-central-1,721,643,78,AWS 0128 MB
aws,dotnet,128,eu-central-1,743,681,62,AWS 0128 MB
aws,dotnet,128,eu-central-1,736,658,78,AWS 0128 MB
aws,dotnet,128,eu-central-1,756,660,96,AWS 0128 MB
aws,dotnet,128,eu-central-1,719,646,73,AWS 0128 MB
aws,dotnet,128,eu-central-1,1090,667,423,AWS 0128 MB
aws,dotnet,128,eu-central-1,849,678,171,AWS 0128 MB
aws,dotnet,128,eu-central-1,730,666,64,AWS 0128 MB
aws,dotnet,128,eu-central-1,742,670,72,AWS 0128 MB
aws,dotnet,128,eu-central-1,740,679,61,AWS 0128 MB
aws,dotnet,128,eu-central-1,738,666,72,AWS 0128 MB
aws,dotnet,128,eu-central-1,769,682,87,AWS 0128 MB
aws,dotnet,128,eu-central-1,759,663,96,AWS 0128 MB
aws,dotnet,128,eu-central-1,739,677,62,AWS 0128 MB
aws,dotnet,128,eu-central-1,755,662,93,AWS 0128 MB
aws,dotnet,128,eu-central-1,736,666,70,AWS 0128 MB
aws,dotnet,128,eu-central-1,740,655,85,AWS 0128 MB
aws,dotnet,128,eu-central-1,763,694,69,AWS 0128 MB
aws,dotnet,128,eu-central-1,720,662,58,AWS 0128 MB
aws,dotnet,128,eu-central-1,759,663,96,AWS 0128 MB
aws,dotnet,128,eu-central-1,742,663,79,AWS 0128 MB
aws,dotnet,128,eu-central-1,760,670,90,AWS 0128 MB
aws,dotnet,128,eu-central-1,778,649,129,AWS 0128 MB
aws,dotnet,128,eu-central-1,792,655,137,AWS 0128 MB
aws,dotnet,128,eu-central-1,733,657,76,AWS 0128 MB
aws,dotnet,256,eu-central-1,501,340,161,AWS 0256 MB
aws,dotnet,256,eu-central-1,413,339,74,AWS 0256 MB
aws,dotnet,256,eu-central-1,393,323,70,AWS 0256 MB
aws,dotnet,256,eu-central-1,407,335,72,AWS 0256 MB
aws,dotnet,256,eu-central-1,403,339,64,AWS 0256 MB
aws,dotnet,256,eu-central-1,401,326,75,AWS 0256 MB
aws,dotnet,256,eu-central-1,397,327,70,AWS 0256 MB
aws,dotnet,256,eu-central-1,436,343,93,AWS 0256 MB
aws,dotnet,256,eu-central-1,399,318,81,AWS 0256 MB
aws,dotnet,256,eu-central-1,397,326,71,AWS 0256 MB
aws,dotnet,256,eu-central-1,376,306,70,AWS 0256 MB
aws,dotnet,256,eu-central-1,395,319,76,AWS 0256 MB
aws,dotnet,256,eu-central-1,411,327,84,AWS 0256 MB
aws,dotnet,256,eu-central-1,413,328,85,AWS 0256 MB
aws,dotnet,256,eu-central-1,393,335,58,AWS 0256 MB
aws,dotnet,256,eu-central-1,391,323,68,AWS 0256 MB
aws,dotnet,256,eu-central-1,726,343,383,AWS 0256 MB
aws,dotnet,256,eu-central-1,750,346,404,AWS 0256 MB
aws,dotnet,256,eu-central-1,438,356,82,AWS 0256 MB
aws,dotnet,256,eu-central-1,412,336,76,AWS 0256 MB
aws,dotnet,256,eu-central-1,390,327,63,AWS 0256 MB
aws,dotnet,256,eu-central-1,407,327,80,AWS 0256 MB
aws,dotnet,256,eu-central-1,427,345,82,AWS 0256 MB
aws,dotnet,256,eu-central-1,397,323,74,AWS 0256 MB
aws,dotnet,256,eu-central-1,394,340,54,AWS 0256 MB
aws,dotnet,256,eu-central-1,436,338,98,AWS 0256 MB
aws,dotnet,256,eu-central-1,398,324,74,AWS 0256 MB
aws,dotnet,256,eu-central-1,417,331,86,AWS 0256 MB
aws,dotnet,256,eu-central-1,377,314,63,AWS 0256 MB
aws,dotnet,256,eu-central-1,396,327,69,AWS 0256 MB
aws,dotnet,256,eu-central-1,391,330,61,AWS 0256 MB
aws,dotnet,256,eu-central-1,411,339,72,AWS 0256 MB
aws,dotnet,256,eu-central-1,411,343,68,AWS 0256 MB
aws,dotnet,256,eu-central-1,405,315,90,AWS 0256 MB
aws,dotnet,256,eu-central-1,388,335,53,AWS 0256 MB
aws,dotnet,256,eu-central-1,364,307,57,AWS 0256 MB
aws,dotnet,256,eu-central-1,393,319,74,AWS 0256 MB
aws,dotnet,256,eu-central-1,403,324,79,AWS 0256 MB
aws,dotnet,256,eu-central-1,401,323,78,AWS 0256 MB
aws,dotnet,256,eu-central-1,400,323,77,AWS 0256 MB
aws,dotnet,256,eu-central-1,407,333,74,AWS 0256 MB
aws,dotnet,256,eu-central-1,386,331,55,AWS 0256 MB
aws,dotnet,256,eu-central-1,405,335,70,AWS 0256 MB
aws,dotnet,256,eu-central-1,387,312,75,AWS 0256 MB
aws,dotnet,256,eu-central-1,401,331,70,AWS 0256 MB
aws,dotnet,256,eu-central-1,399,335,64,AWS 0256 MB
aws,dotnet,256,eu-central-1,415,335,80,AWS 0256 MB
aws,dotnet,256,eu-central-1,399,315,84,AWS 0256 MB
aws,dotnet,256,eu-central-1,411,321,90,AWS 0256 MB
aws,dotnet,256,eu-central-1,414,327,87,AWS 0256 MB
aws,dotnet,256,eu-central-1,682,339,343,AWS 0256 MB
aws,dotnet,256,eu-central-1,409,338,71,AWS 0256 MB
aws,dotnet,256,eu-central-1,421,334,87,AWS 0256 MB
aws,dotnet,256,eu-central-1,389,327,62,AWS 0256 MB
aws,dotnet,256,eu-central-1,410,334,76,AWS 0256 MB
aws,dotnet,256,eu-central-1,369,310,59,AWS 0256 MB
aws,dotnet,256,eu-central-1,394,335,59,AWS 0256 MB
aws,dotnet,256,eu-central-1,389,331,58,AWS 0256 MB
aws,dotnet,256,eu-central-1,407,337,70,AWS 0256 MB
aws,dotnet,256,eu-central-1,392,336,56,AWS 0256 MB
aws,dotnet,256,eu-central-1,388,324,64,AWS 0256 MB
aws,dotnet,256,eu-central-1,410,335,75,AWS 0256 MB
aws,dotnet,256,eu-central-1,408,327,81,AWS 0256 MB
aws,dotnet,256,eu-central-1,417,353,64,AWS 0256 MB
aws,dotnet,256,eu-central-1,436,364,72,AWS 0256 MB
aws,dotnet,256,eu-central-1,420,339,81,AWS 0256 MB
aws,dotnet,256,eu-central-1,414,356,58,AWS 0256 MB
aws,dotnet,256,eu-central-1,433,359,74,AWS 0256 MB
aws,dotnet,256,eu-central-1,414,339,75,AWS 0256 MB
aws,dotnet,256,eu-central-1,394,327,67,AWS 0256 MB
aws,dotnet,256,eu-central-1,417,343,74,AWS 0256 MB
aws,dotnet,256,eu-central-1,391,319,72,AWS 0256 MB
aws,dotnet,256,eu-central-1,420,307,113,AWS 0256 MB
aws,dotnet,256,eu-central-1,396,323,73,AWS 0256 MB
aws,dotnet,256,eu-central-1,404,307,97,AWS 0256 MB
aws,dotnet,256,eu-central-1,379,327,52,AWS 0256 MB
aws,dotnet,256,eu-central-1,420,346,74,AWS 0256 MB
aws,dotnet,256,eu-central-1,380,316,64,AWS 0256 MB
aws,dotnet,256,eu-central-1,380,323,57,AWS 0256 MB
aws,dotnet,256,eu-central-1,377,323,54,AWS 0256 MB
aws,dotnet,256,eu-central-1,379,315,64,AWS 0256 MB
aws,dotnet,256,eu-central-1,397,331,66,AWS 0256 MB
aws,dotnet,256,eu-central-1,689,335,354,AWS 0256 MB
aws,dotnet,256,eu-central-1,388,335,53,AWS 0256 MB
aws,dotnet,256,eu-central-1,390,328,62,AWS 0256 MB
aws,dotnet,256,eu-central-1,406,323,83,AWS 0256 MB
aws,dotnet,256,eu-central-1,406,335,71,AWS 0256 MB
aws,dotnet,256,eu-central-1,386,327,59,AWS 0256 MB
aws,dotnet,256,eu-central-1,404,341,63,AWS 0256 MB
aws,dotnet,256,eu-central-1,388,327,61,AWS 0256 MB
aws,dotnet,256,eu-central-1,404,331,73,AWS 0256 MB
aws,dotnet,256,eu-central-1,397,315,82,AWS 0256 MB
aws,dotnet,256,eu-central-1,379,323,56,AWS 0256 MB
aws,dotnet,256,eu-central-1,418,335,83,AWS 0256 MB
aws,dotnet,256,eu-central-1,413,307,106,AWS 0256 MB
aws,dotnet,256,eu-central-1,420,332,88,AWS 0256 MB
aws,dotnet,256,eu-central-1,397,339,58,AWS 0256 MB
aws,dotnet,256,eu-central-1,411,331,80,AWS 0256 MB
aws,dotnet,256,eu-central-1,493,311,182,AWS 0256 MB
aws,dotnet,256,eu-central-1,380,327,53,AWS 0256 MB
aws,dotnet,512,eu-central-1,282,176,106,AWS 0512 MB
aws,dotnet,512,eu-central-1,247,167,80,AWS 0512 MB
aws,dotnet,512,eu-central-1,249,154,95,AWS 0512 MB
aws,dotnet,512,eu-central-1,228,151,77,AWS 0512 MB
aws,dotnet,512,eu-central-1,227,159,68,AWS 0512 MB
aws,dotnet,512,eu-central-1,222,151,71,AWS 0512 MB
aws,dotnet,512,eu-central-1,240,159,81,AWS 0512 MB
aws,dotnet,512,eu-central-1,222,158,64,AWS 0512 MB
aws,dotnet,512,eu-central-1,221,155,66,AWS 0512 MB
aws,dotnet,512,eu-central-1,241,167,74,AWS 0512 MB
aws,dotnet,512,eu-central-1,220,151,69,AWS 0512 MB
aws,dotnet,512,eu-central-1,233,151,82,AWS 0512 MB
aws,dotnet,512,eu-central-1,238,155,83,AWS 0512 MB
aws,dotnet,512,eu-central-1,238,154,84,AWS 0512 MB
aws,dotnet,512,eu-central-1,217,150,67,AWS 0512 MB
aws,dotnet,512,eu-central-1,239,167,72,AWS 0512 MB
aws,dotnet,512,eu-central-1,227,154,73,AWS 0512 MB
aws,dotnet,512,eu-central-1,229,155,74,AWS 0512 MB
aws,dotnet,512,eu-central-1,255,166,89,AWS 0512 MB
aws,dotnet,512,eu-central-1,231,159,72,AWS 0512 MB
aws,dotnet,512,eu-central-1,221,155,66,AWS 0512 MB
aws,dotnet,512,eu-central-1,225,159,66,AWS 0512 MB
aws,dotnet,512,eu-central-1,224,151,73,AWS 0512 MB
aws,dotnet,512,eu-central-1,242,163,79,AWS 0512 MB
aws,dotnet,512,eu-central-1,240,158,82,AWS 0512 MB
aws,dotnet,512,eu-central-1,242,147,95,AWS 0512 MB
aws,dotnet,512,eu-central-1,242,160,82,AWS 0512 MB
aws,dotnet,512,eu-central-1,237,155,82,AWS 0512 MB
aws,dotnet,512,eu-central-1,239,167,72,AWS 0512 MB
aws,dotnet,512,eu-central-1,232,157,75,AWS 0512 MB
aws,dotnet,512,eu-central-1,249,175,74,AWS 0512 MB
aws,dotnet,512,eu-central-1,234,163,71,AWS 0512 MB
aws,dotnet,512,eu-central-1,268,167,101,AWS 0512 MB
aws,dotnet,512,eu-central-1,253,169,84,AWS 0512 MB
aws,dotnet,512,eu-central-1,230,162,68,AWS 0512 MB
aws,dotnet,512,eu-central-1,228,166,62,AWS 0512 MB
aws,dotnet,512,eu-central-1,236,151,85,AWS 0512 MB
aws,dotnet,512,eu-central-1,250,155,95,AWS 0512 MB
aws,dotnet,512,eu-central-1,244,167,77,AWS 0512 MB
aws,dotnet,512,eu-central-1,249,166,83,AWS 0512 MB
aws,dotnet,512,eu-central-1,242,159,83,AWS 0512 MB
aws,dotnet,512,eu-central-1,224,163,61,AWS 0512 MB
aws,dotnet,512,eu-central-1,254,180,74,AWS 0512 MB
aws,dotnet,512,eu-central-1,237,168,69,AWS 0512 MB
aws,dotnet,512,eu-central-1,215,146,69,AWS 0512 MB
aws,dotnet,512,eu-central-1,237,166,71,AWS 0512 MB
aws,dotnet,512,eu-central-1,232,159,73,AWS 0512 MB
aws,dotnet,512,eu-central-1,723,158,565,AWS 0512 MB
aws,dotnet,512,eu-central-1,301,163,138,AWS 0512 MB
aws,dotnet,512,eu-central-1,255,167,88,AWS 0512 MB
aws,dotnet,512,eu-central-1,234,162,72,AWS 0512 MB
aws,dotnet,512,eu-central-1,232,163,69,AWS 0512 MB
aws,dotnet,512,eu-central-1,410,166,244,AWS 0512 MB
aws,dotnet,512,eu-central-1,229,155,74,AWS 0512 MB
aws,dotnet,512,eu-central-1,230,167,63,AWS 0512 MB
aws,dotnet,512,eu-central-1,228,159,69,AWS 0512 MB
aws,dotnet,512,eu-central-1,427,159,268,AWS 0512 MB
aws,dotnet,512,eu-central-1,213,154,59,AWS 0512 MB
aws,dotnet,512,eu-central-1,229,158,71,AWS 0512 MB
aws,dotnet,512,eu-central-1,243,163,80,AWS 0512 MB
aws,dotnet,512,eu-central-1,246,167,79,AWS 0512 MB
aws,dotnet,512,eu-central-1,231,147,84,AWS 0512 MB
aws,dotnet,512,eu-central-1,231,163,68,AWS 0512 MB
aws,dotnet,512,eu-central-1,212,147,65,AWS 0512 MB
aws,dotnet,512,eu-central-1,231,159,72,AWS 0512 MB
aws,dotnet,512,eu-central-1,222,162,60,AWS 0512 MB
aws,dotnet,512,eu-central-1,246,155,91,AWS 0512 MB
aws,dotnet,512,eu-central-1,230,163,67,AWS 0512 MB
aws,dotnet,512,eu-central-1,237,162,75,AWS 0512 MB
aws,dotnet,512,eu-central-1,232,155,77,AWS 0512 MB
aws,dotnet,512,eu-central-1,233,160,73,AWS 0512 MB
aws,dotnet,512,eu-central-1,232,164,68,AWS 0512 MB
aws,dotnet,512,eu-central-1,421,148,273,AWS 0512 MB
aws,dotnet,512,eu-central-1,270,163,107,AWS 0512 MB
aws,dotnet,512,eu-central-1,233,164,69,AWS 0512 MB
aws,dotnet,512,eu-central-1,224,159,65,AWS 0512 MB
aws,dotnet,512,eu-central-1,218,160,58,AWS 0512 MB
aws,dotnet,512,eu-central-1,220,154,66,AWS 0512 MB
aws,dotnet,512,eu-central-1,640,166,474,AWS 0512 MB
aws,dotnet,512,eu-central-1,242,163,79,AWS 0512 MB
aws,dotnet,512,eu-central-1,534,159,375,AWS 0512 MB
aws,dotnet,512,eu-central-1,214,159,55,AWS 0512 MB
aws,dotnet,512,eu-central-1,236,151,85,AWS 0512 MB
aws,dotnet,512,eu-central-1,236,155,81,AWS 0512 MB
aws,dotnet,512,eu-central-1,234,167,67,AWS 0512 MB
aws,dotnet,512,eu-central-1,234,154,80,AWS 0512 MB
aws,dotnet,512,eu-central-1,239,154,85,AWS 0512 MB
aws,dotnet,512,eu-central-1,233,159,74,AWS 0512 MB
aws,dotnet,512,eu-central-1,232,159,73,AWS 0512 MB
aws,dotnet,512,eu-central-1,235,159,76,AWS 0512 MB
aws,dotnet,512,eu-central-1,245,160,85,AWS 0512 MB
aws,dotnet,512,eu-central-1,229,159,70,AWS 0512 MB
aws,dotnet,512,eu-central-1,676,151,525,AWS 0512 MB
aws,dotnet,512,eu-central-1,233,163,70,AWS 0512 MB
aws,dotnet,512,eu-central-1,249,166,83,AWS 0512 MB
aws,dotnet,512,eu-central-1,227,160,67,AWS 0512 MB
aws,dotnet,512,eu-central-1,231,159,72,AWS 0512 MB
aws,dotnet,512,eu-central-1,244,154,90,AWS 0512 MB
aws,dotnet,512,eu-central-1,251,162,89,AWS 0512 MB
aws,dotnet,512,eu-central-1,224,155,69,AWS 0512 MB
aws,dotnet,1024,eu-central-1,459,79,380,AWS 1024 MB
aws,dotnet,1024,eu-central-1,150,78,72,AWS 1024 MB
aws,dotnet,1024,eu-central-1,145,86,59,AWS 1024 MB
aws,dotnet,1024,eu-central-1,148,81,67,AWS 1024 MB
aws,dotnet,1024,eu-central-1,144,86,58,AWS 1024 MB
aws,dotnet,1024,eu-central-1,148,78,70,AWS 1024 MB
aws,dotnet,1024,eu-central-1,157,86,71,AWS 1024 MB
aws,dotnet,1024,eu-central-1,138,82,56,AWS 1024 MB
aws,dotnet,1024,eu-central-1,140,86,54,AWS 1024 MB
aws,dotnet,1024,eu-central-1,156,78,78,AWS 1024 MB
aws,dotnet,1024,eu-central-1,156,78,78,AWS 1024 MB
aws,dotnet,1024,eu-central-1,136,74,62,AWS 1024 MB
aws,dotnet,1024,eu-central-1,147,82,65,AWS 1024 MB
aws,dotnet,1024,eu-central-1,210,83,127,AWS 1024 MB
aws,dotnet,1024,eu-central-1,158,78,80,AWS 1024 MB
aws,dotnet,1024,eu-central-1,147,83,64,AWS 1024 MB
aws,dotnet,1024,eu-central-1,158,87,71,AWS 1024 MB
aws,dotnet,1024,eu-central-1,165,74,91,AWS 1024 MB
aws,dotnet,1024,eu-central-1,129,74,55,AWS 1024 MB
aws,dotnet,1024,eu-central-1,157,83,74,AWS 1024 MB
aws,dotnet,1024,eu-central-1,157,88,69,AWS 1024 MB
aws,dotnet,1024,eu-central-1,136,79,57,AWS 1024 MB
aws,dotnet,1024,eu-central-1,132,78,54,AWS 1024 MB
aws,dotnet,1024,eu-central-1,153,83,70,AWS 1024 MB
aws,dotnet,1024,eu-central-1,150,78,72,AWS 1024 MB
aws,dotnet,1024,eu-central-1,165,78,87,AWS 1024 MB
aws,dotnet,1024,eu-central-1,167,84,83,AWS 1024 MB
aws,dotnet,1024,eu-central-1,144,79,65,AWS 1024 MB
aws,dotnet,1024,eu-central-1,182,79,103,AWS 1024 MB
aws,dotnet,1024,eu-central-1,131,74,57,AWS 1024 MB
aws,dotnet,1024,eu-central-1,162,87,75,AWS 1024 MB
aws,dotnet,1024,eu-central-1,157,82,75,AWS 1024 MB
aws,dotnet,1024,eu-central-1,156,84,72,AWS 1024 MB
aws,dotnet,1024,eu-central-1,140,78,62,AWS 1024 MB
aws,dotnet,1024,eu-central-1,137,82,55,AWS 1024 MB
aws,dotnet,1024,eu-central-1,155,82,73,AWS 1024 MB
aws,dotnet,1024,eu-central-1,151,82,69,AWS 1024 MB
aws,dotnet,1024,eu-central-1,131,80,51,AWS 1024 MB
aws,dotnet,1024,eu-central-1,153,75,78,AWS 1024 MB
aws,dotnet,1024,eu-central-1,141,83,58,AWS 1024 MB
aws,dotnet,1024,eu-central-1,159,87,72,AWS 1024 MB
aws,dotnet,1024,eu-central-1,134,83,51,AWS 1024 MB
aws,dotnet,1024,eu-central-1,141,78,63,AWS 1024 MB
aws,dotnet,1024,eu-central-1,153,83,70,AWS 1024 MB
aws,dotnet,1024,eu-central-1,152,79,73,AWS 1024 MB
aws,dotnet,1024,eu-central-1,150,87,63,AWS 1024 MB
aws,dotnet,1024,eu-central-1,153,76,77,AWS 1024 MB
aws,dotnet,1024,eu-central-1,133,83,50,AWS 1024 MB
aws,dotnet,1024,eu-central-1,137,78,59,AWS 1024 MB
aws,dotnet,1024,eu-central-1,149,86,63,AWS 1024 MB
aws,dotnet,1024,eu-central-1,403,84,319,AWS 1024 MB
aws,dotnet,1024,eu-central-1,133,78,55,AWS 1024 MB
aws,dotnet,1024,eu-central-1,150,79,71,AWS 1024 MB
aws,dotnet,1024,eu-central-1,146,82,64,AWS 1024 MB
aws,dotnet,1024,eu-central-1,145,87,58,AWS 1024 MB
aws,dotnet,1024,eu-central-1,145,87,58,AWS 1024 MB
aws,dotnet,1024,eu-central-1,142,86,56,AWS 1024 MB
aws,dotnet,1024,eu-central-1,161,78,83,AWS 1024 MB
aws,dotnet,1024,eu-central-1,130,78,52,AWS 1024 MB
aws,dotnet,1024,eu-central-1,145,79,66,AWS 1024 MB
aws,dotnet,1024,eu-central-1,137,83,54,AWS 1024 MB
aws,dotnet,1024,eu-central-1,146,78,68,AWS 1024 MB
aws,dotnet,1024,eu-central-1,142,79,63,AWS 1024 MB
aws,dotnet,1024,eu-central-1,145,74,71,AWS 1024 MB
aws,dotnet,1024,eu-central-1,138,78,60,AWS 1024 MB
aws,dotnet,1024,eu-central-1,134,83,51,AWS 1024 MB
aws,dotnet,1024,eu-central-1,153,82,71,AWS 1024 MB
aws,dotnet,1024,eu-central-1,153,82,71,AWS 1024 MB
aws,dotnet,1024,eu-central-1,157,78,79,AWS 1024 MB
aws,dotnet,1024,eu-central-1,147,75,72,AWS 1024 MB
aws,dotnet,1024,eu-central-1,147,83,64,AWS 1024 MB
aws,dotnet,1024,eu-central-1,150,74,76,AWS 1024 MB
aws,dotnet,1024,eu-central-1,608,78,530,AWS 1024 MB
aws,dotnet,1024,eu-central-1,161,80,81,AWS 1024 MB
aws,dotnet,1024,eu-central-1,143,75,68,AWS 1024 MB
aws,dotnet,1024,eu-central-1,158,79,79,AWS 1024 MB
aws,dotnet,1024,eu-central-1,145,79,66,AWS 1024 MB
aws,dotnet,1024,eu-central-1,140,79,61,AWS 1024 MB
aws,dotnet,1024,eu-central-1,158,78,80,AWS 1024 MB
aws,dotnet,1024,eu-central-1,140,78,62,AWS 1024 MB
aws,dotnet,1024,eu-central-1,157,82,75,AWS 1024 MB
aws,dotnet,1024,eu-central-1,153,86,67,AWS 1024 MB
aws,dotnet,1024,eu-central-1,135,78,57,AWS 1024 MB
aws,dotnet,1024,eu-central-1,155,78,77,AWS 1024 MB
aws,dotnet,1024,eu-central-1,156,79,77,AWS 1024 MB
aws,dotnet,1024,eu-central-1,153,78,75,AWS 1024 MB
aws,dotnet,1024,eu-central-1,147,78,69,AWS 1024 MB
aws,dotnet,1024,eu-central-1,133,74,59,AWS 1024 MB
aws,dotnet,1024,eu-central-1,180,74,106,AWS 1024 MB
aws,dotnet,1024,eu-central-1,147,78,69,AWS 1024 MB
aws,dotnet,1024,eu-central-1,133,74,59,AWS 1024 MB
aws,dotnet,1024,eu-central-1,133,74,59,AWS 1024 MB
aws,dotnet,1024,eu-central-1,132,80,52,AWS 1024 MB
aws,dotnet,1024,eu-central-1,131,79,52,AWS 1024 MB
aws,dotnet,1024,eu-central-1,135,75,60,AWS 1024 MB
aws,dotnet,1024,eu-central-1,148,83,65,AWS 1024 MB
aws,dotnet,1024,eu-central-1,147,78,69,AWS 1024 MB
aws,dotnet,1024,eu-central-1,338,82,256,AWS 1024 MB
aws,dotnet,1024,eu-central-1,162,86,76,AWS 1024 MB
aws,dotnet,1024,eu-central-1,126,74,52,AWS 1024 MB
aws,dotnet,2048,eu-central-1,163,50,113,AWS 2048 MB
aws,dotnet,2048,eu-central-1,124,50,74,AWS 2048 MB
aws,dotnet,2048,eu-central-1,114,50,64,AWS 2048 MB
aws,dotnet,2048,eu-central-1,102,50,52,AWS 2048 MB
aws,dotnet,2048,eu-central-1,112,51,61,AWS 2048 MB
aws,dotnet,2048,eu-central-1,107,50,57,AWS 2048 MB
aws,dotnet,2048,eu-central-1,128,50,78,AWS 2048 MB
aws,dotnet,2048,eu-central-1,135,50,85,AWS 2048 MB
aws,dotnet,2048,eu-central-1,123,50,73,AWS 2048 MB
aws,dotnet,2048,eu-central-1,122,50,72,AWS 2048 MB
aws,dotnet,2048,eu-central-1,125,50,75,AWS 2048 MB
aws,dotnet,2048,eu-central-1,112,50,62,AWS 2048 MB
aws,dotnet,2048,eu-central-1,143,50,93,AWS 2048 MB
aws,dotnet,2048,eu-central-1,119,50,69,AWS 2048 MB
aws,dotnet,2048,eu-central-1,123,50,73,AWS 2048 MB
aws,dotnet,2048,eu-central-1,110,50,60,AWS 2048 MB
aws,dotnet,2048,eu-central-1,114,50,64,AWS 2048 MB
aws,dotnet,2048,eu-central-1,119,50,69,AWS 2048 MB
aws,dotnet,2048,eu-central-1,144,50,94,AWS 2048 MB
aws,dotnet,2048,eu-central-1,125,51,74,AWS 2048 MB
aws,dotnet,2048,eu-central-1,137,50,87,AWS 2048 MB
aws,dotnet,2048,eu-central-1,117,50,67,AWS 2048 MB
aws,dotnet,2048,eu-central-1,118,50,68,AWS 2048 MB
aws,dotnet,2048,eu-central-1,117,50,67,AWS 2048 MB
aws,dotnet,2048,eu-central-1,140,50,90,AWS 2048 MB
aws,dotnet,2048,eu-central-1,131,50,81,AWS 2048 MB
aws,dotnet,2048,eu-central-1,119,50,69,AWS 2048 MB
aws,dotnet,2048,eu-central-1,105,50,55,AWS 2048 MB
aws,dotnet,2048,eu-central-1,121,50,71,AWS 2048 MB
aws,dotnet,2048,eu-central-1,121,50,71,AWS 2048 MB
aws,dotnet,2048,eu-central-1,113,50,63,AWS 2048 MB
aws,dotnet,2048,eu-central-1,127,50,77,AWS 2048 MB
aws,dotnet,2048,eu-central-1,127,50,77,AWS 2048 MB
aws,dotnet,2048,eu-central-1,113,50,63,AWS 2048 MB
aws,dotnet,2048,eu-central-1,121,50,71,AWS 2048 MB
aws,dotnet,2048,eu-central-1,124,50,74,AWS 2048 MB
aws,dotnet,2048,eu-central-1,137,50,87,AWS 2048 MB
aws,dotnet,2048,eu-central-1,118,50,68,AWS 2048 MB
aws,dotnet,2048,eu-central-1,112,50,62,AWS 2048 MB
aws,dotnet,2048,eu-central-1,125,51,74,AWS 2048 MB
aws,dotnet,2048,eu-central-1,121,50,71,AWS 2048 MB
aws,dotnet,2048,eu-central-1,115,50,65,AWS 2048 MB
aws,dotnet,2048,eu-central-1,123,50,73,AWS 2048 MB
aws,dotnet,2048,eu-central-1,132,50,82,AWS 2048 MB
aws,dotnet,2048,eu-central-1,118,50,68,AWS 2048 MB
aws,dotnet,2048,eu-central-1,128,50,78,AWS 2048 MB
aws,dotnet,2048,eu-central-1,120,50,70,AWS 2048 MB
aws,dotnet,2048,eu-central-1,122,50,72,AWS 2048 MB
aws,dotnet,2048,eu-central-1,141,51,90,AWS 2048 MB
aws,dotnet,2048,eu-central-1,141,50,91,AWS 2048 MB
aws,dotnet,2048,eu-central-1,109,56,53,AWS 2048 MB
aws,dotnet,2048,eu-central-1,133,63,70,AWS 2048 MB
aws,dotnet,2048,eu-central-1,120,51,69,AWS 2048 MB
aws,dotnet,2048,eu-central-1,123,50,73,AWS 2048 MB
aws,dotnet,2048,eu-central-1,118,50,68,AWS 2048 MB
aws,dotnet,2048,eu-central-1,104,50,54,AWS 2048 MB
aws,dotnet,2048,eu-central-1,146,64,82,AWS 2048 MB
aws,dotnet,2048,eu-central-1,136,61,75,AWS 2048 MB
aws,dotnet,2048,eu-central-1,115,51,64,AWS 2048 MB
aws,dotnet,2048,eu-central-1,117,50,67,AWS 2048 MB
aws,dotnet,2048,eu-central-1,146,50,96,AWS 2048 MB
aws,dotnet,2048,eu-central-1,612,50,562,AWS 2048 MB
aws,dotnet,2048,eu-central-1,110,50,60,AWS 2048 MB
aws,dotnet,2048,eu-central-1,117,50,67,AWS 2048 MB
aws,dotnet,2048,eu-central-1,121,51,70,AWS 2048 MB
aws,dotnet,2048,eu-central-1,109,50,59,AWS 2048 MB
aws,dotnet,2048,eu-central-1,121,50,71,AWS 2048 MB
aws,dotnet,2048,eu-central-1,123,50,73,AWS 2048 MB
aws,dotnet,2048,eu-central-1,126,51,75,AWS 2048 MB
aws,dotnet,2048,eu-central-1,136,50,86,AWS 2048 MB
aws,dotnet,2048,eu-central-1,102,50,52,AWS 2048 MB
aws,dotnet,2048,eu-central-1,114,50,64,AWS 2048 MB
aws,dotnet,2048,eu-central-1,134,50,84,AWS 2048 MB
aws,dotnet,2048,eu-central-1,142,50,92,AWS 2048 MB
aws,dotnet,2048,eu-central-1,120,50,70,AWS 2048 MB
aws,dotnet,2048,eu-central-1,132,50,82,AWS 2048 MB
aws,dotnet,2048,eu-central-1,116,50,66,AWS 2048 MB
aws,dotnet,2048,eu-central-1,117,50,67,AWS 2048 MB
aws,dotnet,2048,eu-central-1,120,51,69,AWS 2048 MB
aws,dotnet,2048,eu-central-1,120,52,68,AWS 2048 MB
aws,dotnet,2048,eu-central-1,137,50,87,AWS 2048 MB
aws,dotnet,2048,eu-central-1,128,50,78,AWS 2048 MB
aws,dotnet,2048,eu-central-1,108,50,58,AWS 2048 MB
aws,dotnet,2048,eu-central-1,113,50,63,AWS 2048 MB
aws,dotnet,2048,eu-central-1,137,50,87,AWS 2048 MB
aws,dotnet,2048,eu-central-1,118,50,68,AWS 2048 MB
aws,dotnet,2048,eu-central-1,101,50,51,AWS 2048 MB
aws,dotnet,2048,eu-central-1,126,50,76,AWS 2048 MB
aws,dotnet,2048,eu-central-1,126,50,76,AWS 2048 MB
aws,dotnet,2048,eu-central-1,128,50,78,AWS 2048 MB
aws,dotnet,2048,eu-central-1,102,50,52,AWS 2048 MB
aws,dotnet,2048,eu-central-1,127,50,77,AWS 2048 MB
aws,dotnet,2048,eu-central-1,122,50,72,AWS 2048 MB
aws,dotnet,2048,eu-central-1,126,50,76,AWS 2048 MB
aws,dotnet,2048,eu-central-1,100,50,50,AWS 2048 MB
aws,dotnet,2048,eu-central-1,128,50,78,AWS 2048 MB
aws,dotnet,2048,eu-central-1,147,50,97,AWS 2048 MB
aws,dotnet,2048,eu-central-1,111,50,61,AWS 2048 MB
aws,dotnet,2048,eu-central-1,103,50,53,AWS 2048 MB
aws,dotnet,2048,eu-central-1,121,51,70,AWS 2048 MB
azure,dotnet,1536,westeurope,417,86,331,Azure 1536 MB
azure,dotnet,1536,westeurope,243,87,156,Azure 1536 MB
azure,dotnet,1536,westeurope,197,84,113,Azure 1536 MB
azure,dotnet,1536,westeurope,226,83,143,Azure 1536 MB
azure,dotnet,1536,westeurope,228,96,132,Azure 1536 MB
azure,dotnet,1536,westeurope,240,89,151,Azure 1536 MB
azure,dotnet,1536,westeurope,260,127,133,Azure 1536 MB
azure,dotnet,1536,westeurope,336,100,236,Azure 1536 MB
azure,dotnet,1536,westeurope,233,87,146,Azure 1536 MB
azure,dotnet,1536,westeurope,246,107,139,Azure 1536 MB
azure,dotnet,1536,westeurope,227,88,139,Azure 1536 MB
azure,dotnet,1536,westeurope,224,97,127,Azure 1536 MB
azure,dotnet,1536,westeurope,236,97,139,Azure 1536 MB
azure,dotnet,1536,westeurope,236,89,147,Azure 1536 MB
azure,dotnet,1536,westeurope,319,87,232,Azure 1536 MB
azure,dotnet,1536,westeurope,208,85,123,Azure 1536 MB
azure,dotnet,1536,westeurope,248,109,139,Azure 1536 MB
azure,dotnet,1536,westeurope,218,88,130,Azure 1536 MB
azure,dotnet,1536,westeurope,234,85,149,Azure 1536 MB
azure,dotnet,1536,westeurope,237,97,140,Azure 1536 MB
azure,dotnet,1536,westeurope,210,88,122,Azure 1536 MB
azure,dotnet,1536,westeurope,338,92,246,Azure 1536 MB
azure,dotnet,1536,westeurope,207,83,124,Azure 1536 MB
azure,dotnet,1536,westeurope,255,107,148,Azure 1536 MB
azure,dotnet,1536,westeurope,225,88,137,Azure 1536 MB
azure,dotnet,1536,westeurope,206,86,120,Azure 1536 MB
azure,dotnet,1536,westeurope,233,85,148,Azure 1536 MB
azure,dotnet,1536,westeurope,227,94,133,Azure 1536 MB
azure,dotnet,1536,westeurope,289,87,202,Azure 1536 MB
azure,dotnet,1536,westeurope,204,89,115,Azure 1536 MB
azure,dotnet,1536,westeurope,321,100,221,Azure 1536 MB
azure,dotnet,1536,westeurope,266,104,162,Azure 1536 MB
azure,dotnet,1536,westeurope,251,95,156,Azure 1536 MB
azure,dotnet,1536,westeurope,247,95,152,Azure 1536 MB
azure,dotnet,1536,westeurope,206,85,121,Azure 1536 MB
azure,dotnet,1536,westeurope,603,85,518,Azure 1536 MB
azure,dotnet,1536,westeurope,214,96,118,Azure 1536 MB
azure,dotnet,1536,westeurope,243,89,154,Azure 1536 MB
azure,dotnet,1536,westeurope,231,85,146,Azure 1536 MB
azure,dotnet,1536,westeurope,244,99,145,Azure 1536 MB
azure,dotnet,1536,westeurope,224,87,137,Azure 1536 MB
azure,dotnet,1536,westeurope,191,89,102,Azure 1536 MB
azure,dotnet,1536,westeurope,320,83,237,Azure 1536 MB
azure,dotnet,1536,westeurope,216,97,119,Azure 1536 MB
azure,dotnet,1536,westeurope,224,89,135,Azure 1536 MB
azure,dotnet,1536,westeurope,232,91,141,Azure 1536 MB
azure,dotnet,1536,westeurope,210,88,122,Azure 1536 MB
azure,dotnet,1536,westeurope,217,100,117,Azure 1536 MB
azure,dotnet,1536,westeurope,280,100,180,Azure 1536 MB
azure,dotnet,1536,westeurope,336,94,242,Azure 1536 MB
azure,dotnet,1536,westeurope,232,95,137,Azure 1536 MB
azure,dotnet,1536,westeurope,244,87,157,Azure 1536 MB
azure,dotnet,1536,westeurope,243,90,153,Azure 1536 MB
azure,dotnet,1536,westeurope,245,84,161,Azure 1536 MB
azure,dotnet,1536,westeurope,219,90,129,Azure 1536 MB
azure,dotnet,1536,westeurope,233,91,142,Azure 1536 MB
azure,dotnet,1536,westeurope,334,97,237,Azure 1536 MB
azure,dotnet,1536,westeurope,219,93,126,Azure 1536 MB
azure,dotnet,1536,westeurope,392,87,305,Azure 1536 MB
azure,dotnet,1536,westeurope,205,84,121,Azure 1536 MB
azure,dotnet,1536,westeurope,260,88,172,Azure 1536 MB
azure,dotnet,1536,westeurope,228,92,136,Azure 1536 MB
azure,dotnet,1536,westeurope,370,94,276,Azure 1536 MB
azure,dotnet,1536,westeurope,247,91,156,Azure 1536 MB
azure,dotnet,1536,westeurope,236,95,141,Azure 1536 MB
azure,dotnet,1536,westeurope,264,106,158,Azure 1536 MB
azure,dotnet,1536,westeurope,237,103,134,Azure 1536 MB
azure,dotnet,1536,westeurope,277,100,177,Azure 1536 MB
azure,dotnet,1536,westeurope,224,91,133,Azure 1536 MB
azure,dotnet,1536,westeurope,337,90,247,Azure 1536 MB
azure,dotnet,1536,westeurope,240,107,133,Azure 1536 MB
azure,dotnet,1536,westeurope,218,89,129,Azure 1536 MB
azure,dotnet,1536,westeurope,215,88,127,Azure 1536 MB
azure,dotnet,1536,westeurope,250,97,153,Azure 1536 MB
azure,dotnet,1536,westeurope,234,89,145,Azure 1536 MB
azure,dotnet,1536,westeurope,257,87,170,Azure 1536 MB
azure,dotnet,1536,westeurope,341,80,261,Azure 1536 MB
azure,dotnet,1536,westeurope,234,99,135,Azure 1536 MB
azure,dotnet,1536,westeurope,241,89,152,Azure 1536 MB
azure,dotnet,1536,westeurope,238,90,148,Azure 1536 MB
azure,dotnet,1536,westeurope,627,100,527,Azure 1536 MB
azure,dotnet,1536,westeurope,317,89,228,Azure 1536 MB
azure,dotnet,1536,westeurope,214,83,131,Azure 1536 MB
azure,dotnet,1536,westeurope,338,86,252,Azure 1536 MB
azure,dotnet,1536,westeurope,242,92,150,Azure 1536 MB
azure,dotnet,1536,westeurope,255,88,167,Azure 1536 MB
azure,dotnet,1536,westeurope,249,88,161,Azure 1536 MB
azure,dotnet,1536,westeurope,217,87,130,Azure 1536 MB
azure,dotnet,1536,westeurope,201,85,116,Azure 1536 MB
azure,dotnet,1536,westeurope,252,88,164,Azure 1536 MB
azure,dotnet,1536,westeurope,313,87,226,Azure 1536 MB
azure,dotnet,1536,westeurope,217,83,134,Azure 1536 MB
azure,dotnet,1536,westeurope,232,81,151,Azure 1536 MB
azure,dotnet,1536,westeurope,209,85,124,Azure 1536 MB
azure,dotnet,1536,westeurope,214,93,121,Azure 1536 MB
azure,dotnet,1536,westeurope,347,87,260,Azure 1536 MB
azure,dotnet,1536,westeurope,304,89,215,Azure 1536 MB
azure,dotnet,1536,westeurope,290,127,163,Azure 1536 MB
azure,dotnet,1536,westeurope,195,86,109,Azure 1536 MB
azure,dotnet,1536,westeurope,240,92,148,Azure 1536 MB
azureWindows,dotnet,1536,westeurope,724,282,442,Azure (Win) 1536 MB
azureWindows,dotnet,1536,westeurope,710,278,432,Azure (Win) 1536 MB
azureWindows,dotnet,1536,westeurope,441,250,191,Azure (Win) 1536 MB
azureWindows,dotnet,1536,westeurope,355,245,110,Azure (Win) 1536 MB
azureWindows,dotnet,1536,westeurope,407,258,149,Azure (Win) 1536 MB
azureWindows,dotnet,1536,westeurope,373,231,142,Azure (Win) 1536 MB
azureWindows,dotnet,1536,westeurope,379,260,119,Azure (Win) 1536 MB
azureWindows,dotnet,1536,westeurope,536,248,288,Azure (Win) 1536 MB
azureWindows,dotnet,1536,westeurope,371,257,114,Azure (Win) 1536 MB
azureWindows,dotnet,1536,westeurope,374,257,117,Azure (Win) 1536 MB
azureWindows,dotnet,1536,westeurope,385,245,140,Azure (Win) 1536 MB
azureWindows,dotnet,1536,westeurope,378,254,124,Azure (Win) 1536 MB
azureWindows,dotnet,1536,westeurope,371,243,128,Azure (Win) 1536 MB
azureWindows,dotnet,1536,westeurope,382,242,140,Azure (Win) 1536 MB
azureWindows,dotnet,1536,westeurope,703,400,303,Azure (Win) 1536 MB
azureWindows,dotnet,1536,westeurope,374,252,122,Azure (Win) 1536 MB
azureWindows,dotnet,1536,westeurope,365,260,105,Azure (Win) 1536 MB
azureWindows,dotnet,1536,westeurope,373,251,122,Azure (Win) 1536 MB
azureWindows,dotnet,1536,westeurope,374,252,122,Azure (Win) 1536 MB
azureWindows,dotnet,1536,westeurope,388,243,145,Azure (Win) 1536 MB
azureWindows,dotnet,1536,westeurope,354,245,109,Azure (Win) 1536 MB
azureWindows,dotnet,1536,westeurope,516,244,272,Azure (Win) 1536 MB
azureWindows,dotnet,1536,westeurope,361,250,111,Azure (Win) 1536 MB
azureWindows,dotnet,1536,westeurope,350,250,100,Azure (Win) 1536 MB
azureWindows,dotnet,1536,westeurope,374,246,128,Azure (Win) 1536 MB
azureWindows,dotnet,1536,westeurope,388,243,145,Azure (Win) 1536 MB
azureWindows,dotnet,1536,westeurope,356,242,114,Azure (Win) 1536 MB
azureWindows,dotnet,1536,westeurope,370,258,112,Azure (Win) 1536 MB
azureWindows,dotnet,1536,westeurope,533,243,290,Azure (Win) 1536 MB
azureWindows,dotnet,1536,westeurope,346,247,99,Azure (Win) 1536 MB
azureWindows,dotnet,1536,westeurope,359,253,106,Azure (Win) 1536 MB
azureWindows,dotnet,1536,westeurope,367,241,126,Azure (Win) 1536 MB
azureWindows,dotnet,1536,westeurope,398,245,153,Azure (Win) 1536 MB
azureWindows,dotnet,1536,westeurope,365,244,121,Azure (Win) 1536 MB
azureWindows,dotnet,1536,westeurope,353,246,107,Azure (Win) 1536 MB
azureWindows,dotnet,1536,westeurope,848,269,579,Azure (Win) 1536 MB
azureWindows,dotnet,1536,westeurope,356,252,104,Azure (Win) 1536 MB
azureWindows,dotnet,1536,westeurope,362,250,112,Azure (Win) 1536 MB
azureWindows,dotnet,1536,westeurope,400,248,152,Azure (Win) 1536 MB
azureWindows,dotnet,1536,westeurope,366,248,118,Azure (Win) 1536 MB
azureWindows,dotnet,1536,westeurope,361,243,118,Azure (Win) 1536 MB
azureWindows,dotnet,1536,westeurope,385,257,128,Azure (Win) 1536 MB
azureWindows,dotnet,1536,westeurope,540,239,301,Azure (Win) 1536 MB
azureWindows,dotnet,1536,westeurope,362,257,105,Azure (Win) 1536 MB
azureWindows,dotnet,1536,westeurope,365,253,112,Azure (Win) 1536 MB
azureWindows,dotnet,1536,westeurope,383,244,139,Azure (Win) 1536 MB
azureWindows,dotnet,1536,westeurope,389,250,139,Azure (Win) 1536 MB
azureWindows,dotnet,1536,westeurope,352,244,108,Azure (Win) 1536 MB
azureWindows,dotnet,1536,westeurope,395,249,146,Azure (Win) 1536 MB
azureWindows,dotnet,1536,westeurope,509,238,271,Azure (Win) 1536 MB
azureWindows,dotnet,1536,westeurope,402,255,147,Azure (Win) 1536 MB
azureWindows,dotnet,1536,westeurope,363,249,114,Azure (Win) 1536 MB
azureWindows,dotnet,1536,westeurope,385,240,145,Azure (Win) 1536 MB
azureWindows,dotnet,1536,westeurope,366,253,113,Azure (Win) 1536 MB
azureWindows,dotnet,1536,westeurope,368,246,122,Azure (Win) 1536 MB
azureWindows,dotnet,1536,westeurope,379,257,122,Azure (Win) 1536 MB
azureWindows,dotnet,1536,westeurope,522,254,268,Azure (Win) 1536 MB
azureWindows,dotnet,1536,westeurope,366,247,119,Azure (Win) 1536 MB
azureWindows,dotnet,1536,westeurope,367,252,115,Azure (Win) 1536 MB
azureWindows,dotnet,1536,westeurope,350,236,114,Azure (Win) 1536 MB
azureWindows,dotnet,1536,westeurope,429,273,156,Azure (Win) 1536 MB
azureWindows,dotnet,1536,westeurope,377,248,129,Azure (Win) 1536 MB
azureWindows,dotnet,1536,westeurope,561,259,302,Azure (Win) 1536 MB
azureWindows,dotnet,1536,westeurope,578,283,295,Azure (Win) 1536 MB
azureWindows,dotnet,1536,westeurope,369,253,116,Azure (Win) 1536 MB
azureWindows,dotnet,1536,westeurope,396,276,120,Azure (Win) 1536 MB
azureWindows,dotnet,1536,westeurope,328,249,79,Azure (Win) 1536 MB
azureWindows,dotnet,1536,westeurope,376,247,129,Azure (Win) 1536 MB
azureWindows,dotnet,1536,westeurope,395,247,148,Azure (Win) 1536 MB
azureWindows,dotnet,1536,westeurope,511,250,261,Azure (Win) 1536 MB
azureWindows,dotnet,1536,westeurope,369,249,120,Azure (Win) 1536 MB
azureWindows,dotnet,1536,westeurope,366,256,110,Azure (Win) 1536 MB
azureWindows,dotnet,1536,westeurope,376,251,125,Azure (Win) 1536 MB
azureWindows,dotnet,1536,westeurope,365,250,115,Azure (Win) 1536 MB
azureWindows,dotnet,1536,westeurope,390,250,140,Azure (Win) 1536 MB
azureWindows,dotnet,1536,westeurope,363,246,117,Azure (Win) 1536 MB
azureWindows,dotnet,1536,westeurope,514,245,269,Azure (Win) 1536 MB
azureWindows,dotnet,1536,westeurope,364,253,111,Azure (Win) 1536 MB
azureWindows,dotnet,1536,westeurope,371,245,126,Azure (Win) 1536 MB
azureWindows,dotnet,1536,westeurope,348,237,111,Azure (Win) 1536 MB
azureWindows,dotnet,1536,westeurope,735,266,469,Azure (Win) 1536 MB
azureWindows,dotnet,1536,westeurope,592,276,316,Azure (Win) 1536 MB
azureWindows,dotnet,1536,westeurope,362,254,108,Azure (Win) 1536 MB
azureWindows,dotnet,1536,westeurope,523,245,278,Azure (Win) 1536 MB
azureWindows,dotnet,1536,westeurope,356,246,110,Azure (Win) 1536 MB
azureWindows,dotnet,1536,westeurope,383,250,133,Azure (Win) 1536 MB
azureWindows,dotnet,1536,westeurope,441,280,161,Azure (Win) 1536 MB
azureWindows,dotnet,1536,westeurope,374,247,127,Azure (Win) 1536 MB
azureWindows,dotnet,1536,westeurope,350,240,110,Azure (Win) 1536 MB
azureWindows,dotnet,1536,westeurope,378,249,129,Azure (Win) 1536 MB
azureWindows,dotnet,1536,westeurope,514,242,272,Azure (Win) 1536 MB
azureWindows,dotnet,1536,westeurope,379,247,132,Azure (Win) 1536 MB
azureWindows,dotnet,1536,westeurope,405,285,120,Azure (Win) 1536 MB
azureWindows,dotnet,1536,westeurope,369,237,132,Azure (Win) 1536 MB
azureWindows,dotnet,1536,westeurope,370,258,112,Azure (Win) 1536 MB
azureWindows,dotnet,1536,westeurope,383,244,139,Azure (Win) 1536 MB
azureWindows,dotnet,1536,westeurope,551,286,265,Azure (Win) 1536 MB
azureWindows,dotnet,1536,westeurope,369,250,119,Azure (Win) 1536 MB
azureWindows,dotnet,1536,westeurope,365,238,127,Azure (Win) 1536 MB
azureWindows,dotnet,1536,westeurope,356,246,110,Azure (Win) 1536 MB
ibm,dotnet,128,eu-de,371,47,324,IBM 0128 MB
ibm,dotnet,128,eu-de,202,48,154,IBM 0128 MB
ibm,dotnet,128,eu-de,188,46,142,IBM 0128 MB
ibm,dotnet,128,eu-de,202,46,156,IBM 0128 MB
ibm,dotnet,128,eu-de,241,46,195,IBM 0128 MB
ibm,dotnet,128,eu-de,230,46,184,IBM 0128 MB
ibm,dotnet,128,eu-de,199,48,151,IBM 0128 MB
ibm,dotnet,128,eu-de,235,47,188,IBM 0128 MB
ibm,dotnet,128,eu-de,206,47,159,IBM 0128 MB
ibm,dotnet,128,eu-de,213,48,165,IBM 0128 MB
ibm,dotnet,128,eu-de,258,46,212,IBM 0128 MB
ibm,dotnet,128,eu-de,227,47,180,IBM 0128 MB
ibm,dotnet,128,eu-de,227,47,180,IBM 0128 MB
ibm,dotnet,128,eu-de,218,48,170,IBM 0128 MB
ibm,dotnet,128,eu-de,229,48,181,IBM 0128 MB
ibm,dotnet,128,eu-de,213,48,165,IBM 0128 MB
ibm,dotnet,128,eu-de,192,46,146,IBM 0128 MB
ibm,dotnet,128,eu-de,212,47,165,IBM 0128 MB
ibm,dotnet,128,eu-de,247,47,200,IBM 0128 MB
ibm,dotnet,128,eu-de,164,46,118,IBM 0128 MB
ibm,dotnet,128,eu-de,203,50,153,IBM 0128 MB
ibm,dotnet,128,eu-de,248,50,198,IBM 0128 MB
ibm,dotnet,128,eu-de,182,46,136,IBM 0128 MB
ibm,dotnet,128,eu-de,213,47,166,IBM 0128 MB
ibm,dotnet,128,eu-de,151,47,104,IBM 0128 MB
ibm,dotnet,128,eu-de,232,47,185,IBM 0128 MB
ibm,dotnet,128,eu-de,210,47,163,IBM 0128 MB
ibm,dotnet,128,eu-de,185,47,138,IBM 0128 MB
ibm,dotnet,128,eu-de,251,47,204,IBM 0128 MB
ibm,dotnet,128,eu-de,192,46,146,IBM 0128 MB
ibm,dotnet,128,eu-de,248,47,201,IBM 0128 MB
ibm,dotnet,128,eu-de,199,46,153,IBM 0128 MB
ibm,dotnet,128,eu-de,210,48,162,IBM 0128 MB
ibm,dotnet,128,eu-de,202,48,154,IBM 0128 MB
ibm,dotnet,128,eu-de,221,46,175,IBM 0128 MB
ibm,dotnet,128,eu-de,529,47,482,IBM 0128 MB
ibm,dotnet,128,eu-de,189,47,142,IBM 0128 MB
ibm,dotnet,128,eu-de,209,55,154,IBM 0128 MB
ibm,dotnet,128,eu-de,222,47,175,IBM 0128 MB
ibm,dotnet,128,eu-de,247,48,199,IBM 0128 MB
ibm,dotnet,128,eu-de,210,48,162,IBM 0128 MB
ibm,dotnet,128,eu-de,206,48,158,IBM 0128 MB
ibm,dotnet,128,eu-de,276,46,230,IBM 0128 MB
ibm,dotnet,128,eu-de,213,49,164,IBM 0128 MB
ibm,dotnet,128,eu-de,213,51,162,IBM 0128 MB
ibm,dotnet,128,eu-de,233,47,186,IBM 0128 MB
ibm,dotnet,128,eu-de,211,47,164,IBM 0128 MB
ibm,dotnet,128,eu-de,265,53,212,IBM 0128 MB
ibm,dotnet,128,eu-de,229,46,183,IBM 0128 MB
ibm,dotnet,128,eu-de,247,47,200,IBM 0128 MB
ibm,dotnet,128,eu-de,246,47,199,IBM 0128 MB
ibm,dotnet,128,eu-de,217,46,171,IBM 0128 MB
ibm,dotnet,128,eu-de,283,47,236,IBM 0128 MB
ibm,dotnet,128,eu-de,138,46,92,IBM 0128 MB
ibm,dotnet,128,eu-de,299,53,246,IBM 0128 MB
ibm,dotnet,128,eu-de,204,47,157,IBM 0128 MB
ibm,dotnet,128,eu-de,272,47,225,IBM 0128 MB
ibm,dotnet,128,eu-de,210,47,163,IBM 0128 MB
ibm,dotnet,128,eu-de,163,48,115,IBM 0128 MB
ibm,dotnet,128,eu-de,196,49,147,IBM 0128 MB
ibm,dotnet,128,eu-de,226,47,179,IBM 0128 MB
ibm,dotnet,128,eu-de,221,47,174,IBM 0128 MB
ibm,dotnet,128,eu-de,290,48,242,IBM 0128 MB
ibm,dotnet,128,eu-de,184,48,136,IBM 0128 MB
ibm,dotnet,128,eu-de,148,47,101,IBM 0128 MB
ibm,dotnet,128,eu-de,317,48,269,IBM 0128 MB
ibm,dotnet,128,eu-de,207,51,156,IBM 0128 MB
ibm,dotnet,128,eu-de,206,47,159,IBM 0128 MB
ibm,dotnet,128,eu-de,216,47,169,IBM 0128 MB
ibm,dotnet,128,eu-de,283,47,236,IBM 0128 MB
ibm,dotnet,128,eu-de,227,48,179,IBM 0128 MB
ibm,dotnet,128,eu-de,196,47,149,IBM 0128 MB
ibm,dotnet,128,eu-de,199,47,152,IBM 0128 MB
ibm,dotnet,128,eu-de,191,47,144,IBM 0128 MB
ibm,dotnet,128,eu-de,229,53,176,IBM 0128 MB
ibm,dotnet,128,eu-de,196,46,150,IBM 0128 MB
ibm,dotnet,128,eu-de,218,47,171,IBM 0128 MB
ibm,dotnet,128,eu-de,198,48,150,IBM 0128 MB
ibm,dotnet,128,eu-de,350,47,303,IBM 0128 MB
ibm,dotnet,128,eu-de,223,47,176,IBM 0128 MB
ibm,dotnet,128,eu-de,568,47,521,IBM 0128 MB
ibm,dotnet,128,eu-de,290,47,243,IBM 0128 MB
ibm,dotnet,128,eu-de,200,48,152,IBM 0128 MB
ibm,dotnet,128,eu-de,253,46,207,IBM 0128 MB
ibm,dotnet,128,eu-de,210,47,163,IBM 0128 MB
ibm,dotnet,128,eu-de,209,48,161,IBM 0128 MB
ibm,dotnet,128,eu-de,219,48,171,IBM 0128 MB
ibm,dotnet,128,eu-de,191,48,143,IBM 0128 MB
ibm,dotnet,128,eu-de,197,47,150,IBM 0128 MB
ibm,dotnet,128,eu-de,13869,84,13785,IBM 0128 MB
ibm,dotnet,128,eu-de,3386,88,3298,IBM 0128 MB
ibm,dotnet,128,eu-de,8912,90,8822,IBM 0128 MB
ibm,dotnet,128,eu-de,248,85,163,IBM 0128 MB
ibm,dotnet,128,eu-de,270,81,189,IBM 0128 MB
ibm,dotnet,128,eu-de,245,83,162,IBM 0128 MB
ibm,dotnet,128,eu-de,266,83,183,IBM 0128 MB
ibm,dotnet,128,eu-de,334,82,252,IBM 0128 MB
ibm,dotnet,128,eu-de,240,82,158,IBM 0128 MB
ibm,dotnet,128,eu-de,268,83,185,IBM 0128 MB
ibm,dotnet,128,eu-de,200,81,119,IBM 0128 MB
ibm,dotnet,256,eu-de,403,87,316,IBM 0256 MB
ibm,dotnet,256,eu-de,318,84,234,IBM 0256 MB
ibm,dotnet,256,eu-de,250,85,165,IBM 0256 MB
ibm,dotnet,256,eu-de,288,84,204,IBM 0256 MB
ibm,dotnet,256,eu-de,244,85,159,IBM 0256 MB
ibm,dotnet,256,eu-de,263,84,179,IBM 0256 MB
ibm,dotnet,256,eu-de,254,84,170,IBM 0256 MB
ibm,dotnet,256,eu-de,274,85,189,IBM 0256 MB
ibm,dotnet,256,eu-de,254,84,170,IBM 0256 MB
ibm,dotnet,256,eu-de,242,85,157,IBM 0256 MB
ibm,dotnet,256,eu-de,246,84,162,IBM 0256 MB
ibm,dotnet,256,eu-de,269,84,185,IBM 0256 MB
ibm,dotnet,256,eu-de,264,85,179,IBM 0256 MB
ibm,dotnet,256,eu-de,268,84,184,IBM 0256 MB
ibm,dotnet,256,eu-de,241,85,156,IBM 0256 MB
ibm,dotnet,256,eu-de,269,86,183,IBM 0256 MB
ibm,dotnet,256,eu-de,574,85,489,IBM 0256 MB
ibm,dotnet,256,eu-de,585,86,499,IBM 0256 MB
ibm,dotnet,256,eu-de,241,84,157,IBM 0256 MB
ibm,dotnet,256,eu-de,255,84,171,IBM 0256 MB
ibm,dotnet,256,eu-de,270,91,179,IBM 0256 MB
ibm,dotnet,256,eu-de,251,84,167,IBM 0256 MB
ibm,dotnet,256,eu-de,258,84,174,IBM 0256 MB
ibm,dotnet,256,eu-de,252,84,168,IBM 0256 MB
ibm,dotnet,256,eu-de,237,86,151,IBM 0256 MB
ibm,dotnet,256,eu-de,273,86,187,IBM 0256 MB
ibm,dotnet,256,eu-de,254,84,170,IBM 0256 MB
ibm,dotnet,256,eu-de,250,84,166,IBM 0256 MB
ibm,dotnet,256,eu-de,242,85,157,IBM 0256 MB
ibm,dotnet,256,eu-de,252,84,168,IBM 0256 MB
ibm,dotnet,256,eu-de,276,88,188,IBM 0256 MB
ibm,dotnet,256,eu-de,246,85,161,IBM 0256 MB
ibm,dotnet,256,eu-de,256,84,172,IBM 0256 MB
ibm,dotnet,256,eu-de,244,84,160,IBM 0256 MB
ibm,dotnet,256,eu-de,271,89,182,IBM 0256 MB
ibm,dotnet,256,eu-de,195,84,111,IBM 0256 MB
ibm,dotnet,256,eu-de,234,84,150,IBM 0256 MB
ibm,dotnet,256,eu-de,268,87,181,IBM 0256 MB
ibm,dotnet,256,eu-de,258,84,174,IBM 0256 MB
ibm,dotnet,256,eu-de,258,86,172,IBM 0256 MB
ibm,dotnet,256,eu-de,289,84,205,IBM 0256 MB
ibm,dotnet,256,eu-de,240,84,156,IBM 0256 MB
ibm,dotnet,256,eu-de,284,84,200,IBM 0256 MB
ibm,dotnet,256,eu-de,252,84,168,IBM 0256 MB
ibm,dotnet,256,eu-de,247,85,162,IBM 0256 MB
ibm,dotnet,256,eu-de,263,86,177,IBM 0256 MB
ibm,dotnet,256,eu-de,247,84,163,IBM 0256 MB
ibm,dotnet,256,eu-de,255,85,170,IBM 0256 MB
ibm,dotnet,256,eu-de,268,84,184,IBM 0256 MB
ibm,dotnet,256,eu-de,274,84,190,IBM 0256 MB
ibm,dotnet,256,eu-de,675,85,590,IBM 0256 MB
ibm,dotnet,256,eu-de,243,84,159,IBM 0256 MB
ibm,dotnet,256,eu-de,217,87,130,IBM 0256 MB
ibm,dotnet,256,eu-de,262,83,179,IBM 0256 MB
ibm,dotnet,256,eu-de,235,84,151,IBM 0256 MB
ibm,dotnet,256,eu-de,239,84,155,IBM 0256 MB
ibm,dotnet,256,eu-de,249,85,164,IBM 0256 MB
ibm,dotnet,256,eu-de,252,86,166,IBM 0256 MB
ibm,dotnet,256,eu-de,322,84,238,IBM 0256 MB
ibm,dotnet,256,eu-de,246,84,162,IBM 0256 MB
ibm,dotnet,256,eu-de,258,84,174,IBM 0256 MB
ibm,dotnet,256,eu-de,272,85,187,IBM 0256 MB
ibm,dotnet,256,eu-de,205,91,114,IBM 0256 MB
ibm,dotnet,256,eu-de,255,86,169,IBM 0256 MB
ibm,dotnet,256,eu-de,282,88,194,IBM 0256 MB
ibm,dotnet,256,eu-de,240,85,155,IBM 0256 MB
ibm,dotnet,256,eu-de,269,85,184,IBM 0256 MB
ibm,dotnet,256,eu-de,213,84,129,IBM 0256 MB
ibm,dotnet,256,eu-de,235,85,150,IBM 0256 MB
ibm,dotnet,256,eu-de,242,84,158,IBM 0256 MB
ibm,dotnet,256,eu-de,237,86,151,IBM 0256 MB
ibm,dotnet,256,eu-de,243,84,159,IBM 0256 MB
ibm,dotnet,256,eu-de,242,84,158,IBM 0256 MB
ibm,dotnet,256,eu-de,257,85,172,IBM 0256 MB
ibm,dotnet,256,eu-de,238,84,154,IBM 0256 MB
ibm,dotnet,256,eu-de,247,84,163,IBM 0256 MB
ibm,dotnet,256,eu-de,263,84,179,IBM 0256 MB
ibm,dotnet,256,eu-de,248,85,163,IBM 0256 MB
ibm,dotnet,256,eu-de,276,84,192,IBM 0256 MB
ibm,dotnet,256,eu-de,245,85,160,IBM 0256 MB
ibm,dotnet,256,eu-de,245,84,161,IBM 0256 MB
ibm,dotnet,256,eu-de,271,84,187,IBM 0256 MB
ibm,dotnet,256,eu-de,686,85,601,IBM 0256 MB
ibm,dotnet,256,eu-de,271,95,176,IBM 0256 MB
ibm,dotnet,256,eu-de,235,86,149,IBM 0256 MB
ibm,dotnet,256,eu-de,263,84,179,IBM 0256 MB
ibm,dotnet,256,eu-de,255,85,170,IBM 0256 MB
ibm,dotnet,256,eu-de,240,84,156,IBM 0256 MB
ibm,dotnet,256,eu-de,253,86,167,IBM 0256 MB
ibm,dotnet,256,eu-de,250,84,166,IBM 0256 MB
ibm,dotnet,256,eu-de,249,86,163,IBM 0256 MB
ibm,dotnet,256,eu-de,273,85,188,IBM 0256 MB
ibm,dotnet,256,eu-de,242,85,157,IBM 0256 MB
ibm,dotnet,256,eu-de,253,84,169,IBM 0256 MB
ibm,dotnet,256,eu-de,251,86,165,IBM 0256 MB
ibm,dotnet,256,eu-de,255,84,171,IBM 0256 MB
ibm,dotnet,256,eu-de,243,86,157,IBM 0256 MB
ibm,dotnet,256,eu-de,250,84,166,IBM 0256 MB
ibm,dotnet,256,eu-de,254,84,170,IBM 0256 MB
ibm,dotnet,256,eu-de,310,87,223,IBM 0256 MB
ibm,dotnet,512,eu-de,283,86,197,IBM 0512 MB
ibm,dotnet,512,eu-de,291,83,208,IBM 0512 MB
ibm,dotnet,512,eu-de,248,88,160,IBM 0512 MB
ibm,dotnet,512,eu-de,256,83,173,IBM 0512 MB
ibm,dotnet,512,eu-de,240,85,155,IBM 0512 MB
ibm,dotnet,512,eu-de,238,85,153,IBM 0512 MB
ibm,dotnet,512,eu-de,244,81,163,IBM 0512 MB
ibm,dotnet,512,eu-de,240,87,153,IBM 0512 MB
ibm,dotnet,512,eu-de,247,87,160,IBM 0512 MB
ibm,dotnet,512,eu-de,244,87,157,IBM 0512 MB
ibm,dotnet,512,eu-de,244,86,158,IBM 0512 MB
ibm,dotnet,512,eu-de,248,84,164,IBM 0512 MB
ibm,dotnet,512,eu-de,254,85,169,IBM 0512 MB
ibm,dotnet,512,eu-de,271,82,189,IBM 0512 MB
ibm,dotnet,512,eu-de,272,88,184,IBM 0512 MB
ibm,dotnet,512,eu-de,245,81,164,IBM 0512 MB
ibm,dotnet,512,eu-de,390,86,304,IBM 0512 MB
ibm,dotnet,512,eu-de,272,83,189,IBM 0512 MB
ibm,dotnet,512,eu-de,199,85,114,IBM 0512 MB
ibm,dotnet,512,eu-de,249,83,166,IBM 0512 MB
ibm,dotnet,512,eu-de,251,86,165,IBM 0512 MB
ibm,dotnet,512,eu-de,238,86,152,IBM 0512 MB
ibm,dotnet,512,eu-de,273,85,188,IBM 0512 MB
ibm,dotnet,512,eu-de,279,85,194,IBM 0512 MB
ibm,dotnet,512,eu-de,258,82,176,IBM 0512 MB
ibm,dotnet,512,eu-de,297,82,215,IBM 0512 MB
ibm,dotnet,512,eu-de,252,83,169,IBM 0512 MB
ibm,dotnet,512,eu-de,261,86,175,IBM 0512 MB
ibm,dotnet,512,eu-de,253,85,168,IBM 0512 MB
ibm,dotnet,512,eu-de,263,84,179,IBM 0512 MB
ibm,dotnet,512,eu-de,257,81,176,IBM 0512 MB
ibm,dotnet,512,eu-de,244,85,159,IBM 0512 MB
ibm,dotnet,512,eu-de,310,82,228,IBM 0512 MB
ibm,dotnet,512,eu-de,248,85,163,IBM 0512 MB
ibm,dotnet,512,eu-de,238,82,156,IBM 0512 MB
ibm,dotnet,512,eu-de,238,82,156,IBM 0512 MB
ibm,dotnet,512,eu-de,247,84,163,IBM 0512 MB
ibm,dotnet,512,eu-de,223,84,139,IBM 0512 MB
ibm,dotnet,512,eu-de,334,84,250,IBM 0512 MB
ibm,dotnet,512,eu-de,266,85,181,IBM 0512 MB
ibm,dotnet,512,eu-de,245,83,162,IBM 0512 MB
ibm,dotnet,512,eu-de,267,82,185,IBM 0512 MB
ibm,dotnet,512,eu-de,234,83,151,IBM 0512 MB
ibm,dotnet,512,eu-de,235,81,154,IBM 0512 MB
ibm,dotnet,512,eu-de,432,83,349,IBM 0512 MB
ibm,dotnet,512,eu-de,248,82,166,IBM 0512 MB
ibm,dotnet,512,eu-de,249,83,166,IBM 0512 MB
ibm,dotnet,512,eu-de,722,84,638,IBM 0512 MB
ibm,dotnet,512,eu-de,238,82,156,IBM 0512 MB
ibm,dotnet,512,eu-de,258,83,175,IBM 0512 MB
ibm,dotnet,512,eu-de,242,84,158,IBM 0512 MB
ibm,dotnet,512,eu-de,228,82,146,IBM 0512 MB
ibm,dotnet,512,eu-de,416,83,333,IBM 0512 MB
ibm,dotnet,512,eu-de,248,82,166,IBM 0512 MB
ibm,dotnet,512,eu-de,307,82,225,IBM 0512 MB
ibm,dotnet,512,eu-de,242,84,158,IBM 0512 MB
ibm,dotnet,512,eu-de,437,82,355,IBM 0512 MB
ibm,dotnet,512,eu-de,261,83,178,IBM 0512 MB
ibm,dotnet,512,eu-de,239,84,155,IBM 0512 MB
ibm,dotnet,512,eu-de,280,82,198,IBM 0512 MB
ibm,dotnet,512,eu-de,244,85,159,IBM 0512 MB
ibm,dotnet,512,eu-de,257,82,175,IBM 0512 MB
ibm,dotnet,512,eu-de,239,83,156,IBM 0512 MB
ibm,dotnet,512,eu-de,248,82,166,IBM 0512 MB
ibm,dotnet,512,eu-de,247,86,161,IBM 0512 MB
ibm,dotnet,512,eu-de,248,84,164,IBM 0512 MB
ibm,dotnet,512,eu-de,264,84,180,IBM 0512 MB
ibm,dotnet,512,eu-de,232,83,149,IBM 0512 MB
ibm,dotnet,512,eu-de,252,82,170,IBM 0512 MB
ibm,dotnet,512,eu-de,304,83,221,IBM 0512 MB
ibm,dotnet,512,eu-de,238,82,156,IBM 0512 MB
ibm,dotnet,512,eu-de,242,82,160,IBM 0512 MB
ibm,dotnet,512,eu-de,426,82,344,IBM 0512 MB
ibm,dotnet,512,eu-de,272,82,190,IBM 0512 MB
ibm,dotnet,512,eu-de,230,81,149,IBM 0512 MB
ibm,dotnet,512,eu-de,233,82,151,IBM 0512 MB
ibm,dotnet,512,eu-de,253,90,163,IBM 0512 MB
ibm,dotnet,512,eu-de,281,81,200,IBM 0512 MB
ibm,dotnet,512,eu-de,687,83,604,IBM 0512 MB
ibm,dotnet,512,eu-de,245,82,163,IBM 0512 MB
ibm,dotnet,512,eu-de,530,83,447,IBM 0512 MB
ibm,dotnet,512,eu-de,234,82,152,IBM 0512 MB
ibm,dotnet,512,eu-de,268,82,186,IBM 0512 MB
ibm,dotnet,512,eu-de,235,82,153,IBM 0512 MB
ibm,dotnet,512,eu-de,248,82,166,IBM 0512 MB
ibm,dotnet,512,eu-de,249,85,164,IBM 0512 MB
ibm,dotnet,512,eu-de,238,82,156,IBM 0512 MB
ibm,dotnet,512,eu-de,239,82,157,IBM 0512 MB
ibm,dotnet,512,eu-de,187,82,105,IBM 0512 MB
ibm,dotnet,512,eu-de,320,86,234,IBM 0512 MB
ibm,dotnet,512,eu-de,233,85,148,IBM 0512 MB
ibm,dotnet,512,eu-de,250,82,168,IBM 0512 MB
ibm,dotnet,512,eu-de,675,84,591,IBM 0512 MB
ibm,dotnet,512,eu-de,230,82,148,IBM 0512 MB
ibm,dotnet,512,eu-de,247,85,162,IBM 0512 MB
ibm,dotnet,512,eu-de,245,83,162,IBM 0512 MB
ibm,dotnet,512,eu-de,234,82,152,IBM 0512 MB
ibm,dotnet,512,eu-de,322,81,241,IBM 0512 MB
ibm,dotnet,512,eu-de,237,81,156,IBM 0512 MB
ibm,dotnet,512,eu-de,243,81,162,IBM 0512 MB
ibm,dotnet,1024,eu-de,535,85,450,IBM 1024 MB
ibm,dotnet,1024,eu-de,183,82,101,IBM 1024 MB
ibm,dotnet,1024,eu-de,267,82,185,IBM 1024 MB
ibm,dotnet,1024,eu-de,235,82,153,IBM 1024 MB
ibm,dotnet,1024,eu-de,257,82,175,IBM 1024 MB
ibm,dotnet,1024,eu-de,204,81,123,IBM 1024 MB
ibm,dotnet,1024,eu-de,250,84,166,IBM 1024 MB
ibm,dotnet,1024,eu-de,272,81,191,IBM 1024 MB
ibm,dotnet,1024,eu-de,234,82,152,IBM 1024 MB
ibm,dotnet,1024,eu-de,246,82,164,IBM 1024 MB
ibm,dotnet,1024,eu-de,243,82,161,IBM 1024 MB
ibm,dotnet,1024,eu-de,237,82,155,IBM 1024 MB
ibm,dotnet,1024,eu-de,317,84,233,IBM 1024 MB
ibm,dotnet,1024,eu-de,279,82,197,IBM 1024 MB
ibm,dotnet,1024,eu-de,301,82,219,IBM 1024 MB
ibm,dotnet,1024,eu-de,286,84,202,IBM 1024 MB
ibm,dotnet,1024,eu-de,318,82,236,IBM 1024 MB
ibm,dotnet,1024,eu-de,265,82,183,IBM 1024 MB
ibm,dotnet,1024,eu-de,221,82,139,IBM 1024 MB
ibm,dotnet,1024,eu-de,232,83,149,IBM 1024 MB
ibm,dotnet,1024,eu-de,277,94,183,IBM 1024 MB
ibm,dotnet,1024,eu-de,235,81,154,IBM 1024 MB
ibm,dotnet,1024,eu-de,253,81,172,IBM 1024 MB
ibm,dotnet,1024,eu-de,306,83,223,IBM 1024 MB
ibm,dotnet,1024,eu-de,229,81,148,IBM 1024 MB
ibm,dotnet,1024,eu-de,248,81,167,IBM 1024 MB
ibm,dotnet,1024,eu-de,319,88,231,IBM 1024 MB
ibm,dotnet,1024,eu-de,252,81,171,IBM 1024 MB
ibm,dotnet,1024,eu-de,255,83,172,IBM 1024 MB
ibm,dotnet,1024,eu-de,190,83,107,IBM 1024 MB
ibm,dotnet,1024,eu-de,245,82,163,IBM 1024 MB
ibm,dotnet,1024,eu-de,184,82,102,IBM 1024 MB
ibm,dotnet,1024,eu-de,230,82,148,IBM 1024 MB
ibm,dotnet,1024,eu-de,231,83,148,IBM 1024 MB
ibm,dotnet,1024,eu-de,224,82,142,IBM 1024 MB
ibm,dotnet,1024,eu-de,337,81,256,IBM 1024 MB
ibm,dotnet,1024,eu-de,254,81,173,IBM 1024 MB
ibm,dotnet,1024,eu-de,246,81,165,IBM 1024 MB
ibm,dotnet,1024,eu-de,275,82,193,IBM 1024 MB
ibm,dotnet,1024,eu-de,247,82,165,IBM 1024 MB
ibm,dotnet,1024,eu-de,238,82,156,IBM 1024 MB
ibm,dotnet,1024,eu-de,250,83,167,IBM 1024 MB
ibm,dotnet,1024,eu-de,275,82,193,IBM 1024 MB
ibm,dotnet,1024,eu-de,235,82,153,IBM 1024 MB
ibm,dotnet,1024,eu-de,188,89,99,IBM 1024 MB
ibm,dotnet,1024,eu-de,301,82,219,IBM 1024 MB
ibm,dotnet,1024,eu-de,251,81,170,IBM 1024 MB
ibm,dotnet,1024,eu-de,196,82,114,IBM 1024 MB
ibm,dotnet,1024,eu-de,242,82,160,IBM 1024 MB
ibm,dotnet,1024,eu-de,329,83,246,IBM 1024 MB
ibm,dotnet,1024,eu-de,494,85,409,IBM 1024 MB
ibm,dotnet,1024,eu-de,244,81,163,IBM 1024 MB
ibm,dotnet,1024,eu-de,288,83,205,IBM 1024 MB
ibm,dotnet,1024,eu-de,248,81,167,IBM 1024 MB
ibm,dotnet,1024,eu-de,326,83,243,IBM 1024 MB
ibm,dotnet,1024,eu-de,194,86,108,IBM 1024 MB
ibm,dotnet,1024,eu-de,229,82,147,IBM 1024 MB
ibm,dotnet,1024,eu-de,255,81,174,IBM 1024 MB
ibm,dotnet,1024,eu-de,229,82,147,IBM 1024 MB
ibm,dotnet,1024,eu-de,254,81,173,IBM 1024 MB
ibm,dotnet,1024,eu-de,244,83,161,IBM 1024 MB
ibm,dotnet,1024,eu-de,245,82,163,IBM 1024 MB
ibm,dotnet,1024,eu-de,240,84,156,IBM 1024 MB
ibm,dotnet,1024,eu-de,264,82,182,IBM 1024 MB
ibm,dotnet,1024,eu-de,242,81,161,IBM 1024 MB
ibm,dotnet,1024,eu-de,316,90,226,IBM 1024 MB
ibm,dotnet,1024,eu-de,192,82,110,IBM 1024 MB
ibm,dotnet,1024,eu-de,315,85,230,IBM 1024 MB
ibm,dotnet,1024,eu-de,279,94,185,IBM 1024 MB
ibm,dotnet,1024,eu-de,202,82,120,IBM 1024 MB
ibm,dotnet,1024,eu-de,233,84,149,IBM 1024 MB
ibm,dotnet,1024,eu-de,246,82,164,IBM 1024 MB
ibm,dotnet,1024,eu-de,728,82,646,IBM 1024 MB
ibm,dotnet,1024,eu-de,247,85,162,IBM 1024 MB
ibm,dotnet,1024,eu-de,290,81,209,IBM 1024 MB
ibm,dotnet,1024,eu-de,265,82,183,IBM 1024 MB
ibm,dotnet,1024,eu-de,229,85,144,IBM 1024 MB
ibm,dotnet,1024,eu-de,194,83,111,IBM 1024 MB
ibm,dotnet,1024,eu-de,275,82,193,IBM 1024 MB
ibm,dotnet,1024,eu-de,241,82,159,IBM 1024 MB
ibm,dotnet,1024,eu-de,288,84,204,IBM 1024 MB
ibm,dotnet,1024,eu-de,195,82,113,IBM 1024 MB
ibm,dotnet,1024,eu-de,249,85,164,IBM 1024 MB
ibm,dotnet,1024,eu-de,327,83,244,IBM 1024 MB
ibm,dotnet,1024,eu-de,288,88,200,IBM 1024 MB
ibm,dotnet,1024,eu-de,265,84,181,IBM 1024 MB
ibm,dotnet,1024,eu-de,243,85,158,IBM 1024 MB
ibm,dotnet,1024,eu-de,186,83,103,IBM 1024 MB
ibm,dotnet,1024,eu-de,323,82,241,IBM 1024 MB
ibm,dotnet,1024,eu-de,238,84,154,IBM 1024 MB
ibm,dotnet,1024,eu-de,268,83,185,IBM 1024 MB
ibm,dotnet,1024,eu-de,303,85,218,IBM 1024 MB
ibm,dotnet,1024,eu-de,289,82,207,IBM 1024 MB
ibm,dotnet,1024,eu-de,230,82,148,IBM 1024 MB
ibm,dotnet,1024,eu-de,249,92,157,IBM 1024 MB
ibm,dotnet,1024,eu-de,282,82,200,IBM 1024 MB
ibm,dotnet,1024,eu-de,292,83,209,IBM 1024 MB
ibm,dotnet,1024,eu-de,432,81,351,IBM 1024 MB
ibm,dotnet,1024,eu-de,253,86,167,IBM 1024 MB
ibm,dotnet,1024,eu-de,279,82,197,IBM 1024 MB
ibm,dotnet,2048,eu-de,280,83,197,IBM 2048 MB
ibm,dotnet,2048,eu-de,248,82,166,IBM 2048 MB
ibm,dotnet,2048,eu-de,262,81,181,IBM 2048 MB
ibm,dotnet,2048,eu-de,310,81,229,IBM 2048 MB
ibm,dotnet,2048,eu-de,233,82,151,IBM 2048 MB
ibm,dotnet,2048,eu-de,228,81,147,IBM 2048 MB
ibm,dotnet,2048,eu-de,246,81,165,IBM 2048 MB
ibm,dotnet,2048,eu-de,279,83,196,IBM 2048 MB
ibm,dotnet,2048,eu-de,236,81,155,IBM 2048 MB
ibm,dotnet,2048,eu-de,677,82,595,IBM 2048 MB
ibm,dotnet,2048,eu-de,244,83,161,IBM 2048 MB
ibm,dotnet,2048,eu-de,257,81,176,IBM 2048 MB
ibm,dotnet,2048,eu-de,301,82,219,IBM 2048 MB
ibm,dotnet,2048,eu-de,307,82,225,IBM 2048 MB
ibm,dotnet,2048,eu-de,249,87,162,IBM 2048 MB
ibm,dotnet,2048,eu-de,261,83,178,IBM 2048 MB
ibm,dotnet,2048,eu-de,241,83,158,IBM 2048 MB
ibm,dotnet,2048,eu-de,230,86,144,IBM 2048 MB
ibm,dotnet,2048,eu-de,241,83,158,IBM 2048 MB
ibm,dotnet,2048,eu-de,307,82,225,IBM 2048 MB
ibm,dotnet,2048,eu-de,251,82,169,IBM 2048 MB
ibm,dotnet,2048,eu-de,229,82,147,IBM 2048 MB
ibm,dotnet,2048,eu-de,235,82,153,IBM 2048 MB
ibm,dotnet,2048,eu-de,249,83,166,IBM 2048 MB
ibm,dotnet,2048,eu-de,237,81,156,IBM 2048 MB
ibm,dotnet,2048,eu-de,263,81,182,IBM 2048 MB
ibm,dotnet,2048,eu-de,179,82,97,IBM 2048 MB
ibm,dotnet,2048,eu-de,185,82,103,IBM 2048 MB
ibm,dotnet,2048,eu-de,363,82,281,IBM 2048 MB
ibm,dotnet,2048,eu-de,264,81,183,IBM 2048 MB
ibm,dotnet,2048,eu-de,249,82,167,IBM 2048 MB
ibm,dotnet,2048,eu-de,242,81,161,IBM 2048 MB
ibm,dotnet,2048,eu-de,241,81,160,IBM 2048 MB
ibm,dotnet,2048,eu-de,242,81,161,IBM 2048 MB
ibm,dotnet,2048,eu-de,243,82,161,IBM 2048 MB
ibm,dotnet,2048,eu-de,233,83,150,IBM 2048 MB
ibm,dotnet,2048,eu-de,262,88,174,IBM 2048 MB
ibm,dotnet,2048,eu-de,249,82,167,IBM 2048 MB
ibm,dotnet,2048,eu-de,244,83,161,IBM 2048 MB
ibm,dotnet,2048,eu-de,260,82,178,IBM 2048 MB
ibm,dotnet,2048,eu-de,239,81,158,IBM 2048 MB
ibm,dotnet,2048,eu-de,234,82,152,IBM 2048 MB
ibm,dotnet,2048,eu-de,291,82,209,IBM 2048 MB
ibm,dotnet,2048,eu-de,211,82,129,IBM 2048 MB
ibm,dotnet,2048,eu-de,241,82,159,IBM 2048 MB
ibm,dotnet,2048,eu-de,304,81,223,IBM 2048 MB
ibm,dotnet,2048,eu-de,343,81,262,IBM 2048 MB
ibm,dotnet,2048,eu-de,241,81,160,IBM 2048 MB
ibm,dotnet,2048,eu-de,237,82,155,IBM 2048 MB
ibm,dotnet,2048,eu-de,263,83,180,IBM 2048 MB
ibm,dotnet,2048,eu-de,228,82,146,IBM 2048 MB
ibm,dotnet,2048,eu-de,196,82,114,IBM 2048 MB
ibm,dotnet,2048,eu-de,235,83,152,IBM 2048 MB
ibm,dotnet,2048,eu-de,246,82,164,IBM 2048 MB
ibm,dotnet,2048,eu-de,249,82,167,IBM 2048 MB
ibm,dotnet,2048,eu-de,241,82,159,IBM 2048 MB
ibm,dotnet,2048,eu-de,259,81,178,IBM 2048 MB
ibm,dotnet,2048,eu-de,242,81,161,IBM 2048 MB
ibm,dotnet,2048,eu-de,252,82,170,IBM 2048 MB
ibm,dotnet,2048,eu-de,184,82,102,IBM 2048 MB
ibm,dotnet,2048,eu-de,239,81,158,IBM 2048 MB
ibm,dotnet,2048,eu-de,804,82,722,IBM 2048 MB
ibm,dotnet,2048,eu-de,196,82,114,IBM 2048 MB
ibm,dotnet,2048,eu-de,281,82,199,IBM 2048 MB
ibm,dotnet,2048,eu-de,248,84,164,IBM 2048 MB
ibm,dotnet,2048,eu-de,272,82,190,IBM 2048 MB
ibm,dotnet,2048,eu-de,234,84,150,IBM 2048 MB
ibm,dotnet,2048,eu-de,268,84,184,IBM 2048 MB
ibm,dotnet,2048,eu-de,257,82,175,IBM 2048 MB
ibm,dotnet,2048,eu-de,204,82,122,IBM 2048 MB
ibm,dotnet,2048,eu-de,229,82,147,IBM 2048 MB
ibm,dotnet,2048,eu-de,286,82,204,IBM 2048 MB
ibm,dotnet,2048,eu-de,229,81,148,IBM 2048 MB
ibm,dotnet,2048,eu-de,401,93,308,IBM 2048 MB
ibm,dotnet,2048,eu-de,247,81,166,IBM 2048 MB
ibm,dotnet,2048,eu-de,186,81,105,IBM 2048 MB
ibm,dotnet,2048,eu-de,257,82,175,IBM 2048 MB
ibm,dotnet,2048,eu-de,247,86,161,IBM 2048 MB
ibm,dotnet,2048,eu-de,224,82,142,IBM 2048 MB
ibm,dotnet,2048,eu-de,231,83,148,IBM 2048 MB
ibm,dotnet,2048,eu-de,240,82,158,IBM 2048 MB
ibm,dotnet,2048,eu-de,252,83,169,IBM 2048 MB
ibm,dotnet,2048,eu-de,233,82,151,IBM 2048 MB
ibm,dotnet,2048,eu-de,232,82,150,IBM 2048 MB
ibm,dotnet,2048,eu-de,245,82,163,IBM 2048 MB
ibm,dotnet,2048,eu-de,280,82,198,IBM 2048 MB
ibm,dotnet,2048,eu-de,240,87,153,IBM 2048 MB
ibm,dotnet,2048,eu-de,269,82,187,IBM 2048 MB
ibm,dotnet,2048,eu-de,241,82,159,IBM 2048 MB
ibm,dotnet,2048,eu-de,190,82,108,IBM 2048 MB
ibm,dotnet,2048,eu-de,228,84,144,IBM 2048 MB
ibm,dotnet,2048,eu-de,351,82,269,IBM 2048 MB
ibm,dotnet,2048,eu-de,249,83,166,IBM 2048 MB
ibm,dotnet,2048,eu-de,276,82,194,IBM 2048 MB
ibm,dotnet,2048,eu-de,183,82,101,IBM 2048 MB
ibm,dotnet,2048,eu-de,244,82,162,IBM 2048 MB
ibm,dotnet,2048,eu-de,260,81,179,IBM 2048 MB
ibm,dotnet,2048,eu-de,203,81,122,IBM 2048 MB
ibm,dotnet,2048,eu-de,224,82,142,IBM 2048 MB
ibm,dotnet,2048,eu-de,278,92,186,IBM 2048 MB
