#idx,cloud,runtime,memory_mb,region,total_ms,measured_ms,latency_ms,name
1,aws,python,128,eu-central-1,8287,8040,247,AWS 128 MB
1,aws,python,128,eu-central-1,8248,7887,361,AWS 128 MB
1,aws,python,128,eu-central-1,8051,7904,147,AWS 128 MB
1,aws,python,128,eu-central-1,8004,7827,177,AWS 128 MB
1,aws,python,128,eu-central-1,8064,7892,172,AWS 128 MB
1,aws,python,128,eu-central-1,8082,7912,170,AWS 128 MB
1,aws,python,128,eu-central-1,8103,7921,182,AWS 128 MB
1,aws,python,128,eu-central-1,8039,7868,171,AWS 128 MB
1,aws,python,128,eu-central-1,8093,7939,154,AWS 128 MB
1,aws,python,128,eu-central-1,8125,7896,229,AWS 128 MB
1,aws,python,128,eu-central-1,8054,7912,142,AWS 128 MB
1,aws,python,128,eu-central-1,8068,7896,172,AWS 128 MB
1,aws,python,128,eu-central-1,8072,7937,135,AWS 128 MB
1,aws,python,128,eu-central-1,8041,7899,142,AWS 128 MB
1,aws,python,128,eu-central-1,8068,7919,149,AWS 128 MB
1,aws,python,128,eu-central-1,8083,7919,164,AWS 128 MB
1,aws,python,128,eu-central-1,8082,7925,157,AWS 128 MB
1,aws,python,128,eu-central-1,8075,7883,192,AWS 128 MB
1,aws,python,128,eu-central-1,8058,7922,136,AWS 128 MB
1,aws,python,128,eu-central-1,7989,7823,166,AWS 128 MB
1,aws,python,128,eu-central-1,8032,7907,125,AWS 128 MB
1,aws,python,128,eu-central-1,7995,7857,138,AWS 128 MB
1,aws,python,128,eu-central-1,8078,7938,140,AWS 128 MB
1,aws,python,128,eu-central-1,8025,7852,173,AWS 128 MB
1,aws,python,128,eu-central-1,8073,7931,142,AWS 128 MB
1,aws,python,128,eu-central-1,8049,7911,138,AWS 128 MB
1,aws,python,128,eu-central-1,8102,7943,159,AWS 128 MB
1,aws,python,128,eu-central-1,8045,7868,177,AWS 128 MB
1,aws,python,128,eu-central-1,8069,7903,166,AWS 128 MB
1,aws,python,128,eu-central-1,8023,7869,154,AWS 128 MB
1,aws,python,128,eu-central-1,8075,7945,130,AWS 128 MB
1,aws,python,128,eu-central-1,8051,7889,162,AWS 128 MB
1,aws,python,128,eu-central-1,8142,7922,220,AWS 128 MB
1,aws,python,128,eu-central-1,8034,7918,116,AWS 128 MB
1,aws,python,128,eu-central-1,8094,7932,162,AWS 128 MB
1,aws,python,128,eu-central-1,8246,7844,402,AWS 128 MB
1,aws,python,128,eu-central-1,8032,7907,125,AWS 128 MB
1,aws,python,128,eu-central-1,8145,7908,237,AWS 128 MB
1,aws,python,128,eu-central-1,8128,7965,163,AWS 128 MB
1,aws,python,128,eu-central-1,8077,7898,179,AWS 128 MB
1,aws,python,128,eu-central-1,8069,7945,124,AWS 128 MB
1,aws,python,128,eu-central-1,8001,7864,137,AWS 128 MB
1,aws,python,128,eu-central-1,8064,7926,138,AWS 128 MB
1,aws,python,128,eu-central-1,8043,7909,134,AWS 128 MB
1,aws,python,128,eu-central-1,8079,7930,149,AWS 128 MB
1,aws,python,128,eu-central-1,8149,7859,290,AWS 128 MB
1,aws,python,128,eu-central-1,8159,8007,152,AWS 128 MB
1,aws,python,128,eu-central-1,8081,7892,189,AWS 128 MB
1,aws,python,128,eu-central-1,8095,7939,156,AWS 128 MB
1,aws,python,128,eu-central-1,8029,7861,168,AWS 128 MB
1,aws,python,128,eu-central-1,8220,7963,257,AWS 128 MB
1,aws,python,128,eu-central-1,8052,7862,190,AWS 128 MB
1,aws,python,128,eu-central-1,8095,7889,206,AWS 128 MB
1,aws,python,128,eu-central-1,8010,7849,161,AWS 128 MB
1,aws,python,128,eu-central-1,8091,7922,169,AWS 128 MB
1,aws,python,128,eu-central-1,8185,7904,281,AWS 128 MB
1,aws,python,128,eu-central-1,8084,7919,165,AWS 128 MB
1,aws,python,128,eu-central-1,8115,7887,228,AWS 128 MB
1,aws,python,128,eu-central-1,8084,7923,161,AWS 128 MB
1,aws,python,128,eu-central-1,8037,7877,160,AWS 128 MB
1,aws,python,128,eu-central-1,8139,7963,176,AWS 128 MB
1,aws,python,128,eu-central-1,8050,7902,148,AWS 128 MB
1,aws,python,128,eu-central-1,8094,7940,154,AWS 128 MB
1,aws,python,128,eu-central-1,8050,7875,175,AWS 128 MB
1,aws,python,128,eu-central-1,8096,7933,163,AWS 128 MB
1,aws,python,128,eu-central-1,8047,7881,166,AWS 128 MB
1,aws,python,128,eu-central-1,8091,7943,148,AWS 128 MB
1,aws,python,128,eu-central-1,8031,7872,159,AWS 128 MB
1,aws,python,128,eu-central-1,8127,7964,163,AWS 128 MB
1,aws,python,128,eu-central-1,7985,7850,135,AWS 128 MB
1,aws,python,128,eu-central-1,8153,7977,176,AWS 128 MB
1,aws,python,128,eu-central-1,8044,7879,165,AWS 128 MB
1,aws,python,128,eu-central-1,8093,7877,216,AWS 128 MB
1,aws,python,128,eu-central-1,8063,7920,143,AWS 128 MB
1,aws,python,128,eu-central-1,8142,7966,176,AWS 128 MB
1,aws,python,128,eu-central-1,8019,7867,152,AWS 128 MB
1,aws,python,128,eu-central-1,8131,7978,153,AWS 128 MB
1,aws,python,128,eu-central-1,7994,7809,185,AWS 128 MB
1,aws,python,128,eu-central-1,8218,7904,314,AWS 128 MB
1,aws,python,128,eu-central-1,8019,7856,163,AWS 128 MB
1,aws,python,128,eu-central-1,8496,7992,504,AWS 128 MB
1,aws,python,128,eu-central-1,8070,7850,220,AWS 128 MB
1,aws,python,128,eu-central-1,8092,7956,136,AWS 128 MB
1,aws,python,128,eu-central-1,8020,7855,165,AWS 128 MB
1,aws,python,128,eu-central-1,8066,7887,179,AWS 128 MB
1,aws,python,128,eu-central-1,8037,7917,120,AWS 128 MB
1,aws,python,128,eu-central-1,8086,7898,188,AWS 128 MB
1,aws,python,128,eu-central-1,7977,7817,160,AWS 128 MB
1,aws,python,128,eu-central-1,8082,7924,158,AWS 128 MB
1,aws,python,128,eu-central-1,8031,7870,161,AWS 128 MB
1,aws,python,128,eu-central-1,8042,7886,156,AWS 128 MB
1,aws,python,128,eu-central-1,8038,7863,175,AWS 128 MB
1,aws,python,128,eu-central-1,8055,7869,186,AWS 128 MB
1,aws,python,128,eu-central-1,8045,7865,180,AWS 128 MB
1,aws,python,128,eu-central-1,8135,7946,189,AWS 128 MB
1,aws,python,128,eu-central-1,7998,7857,141,AWS 128 MB
1,aws,python,128,eu-central-1,8027,7905,122,AWS 128 MB
1,aws,python,128,eu-central-1,8079,7898,181,AWS 128 MB
1,aws,python,128,eu-central-1,8101,7905,196,AWS 128 MB
1,aws,python,128,eu-central-1,8041,7868,173,AWS 128 MB
2,aws,python,256,eu-central-1,4073,3911,162,AWS 256 MB
2,aws,python,256,eu-central-1,4038,3902,136,AWS 256 MB
2,aws,python,256,eu-central-1,4036,3933,103,AWS 256 MB
2,aws,python,256,eu-central-1,4032,3914,118,AWS 256 MB
2,aws,python,256,eu-central-1,4127,4015,112,AWS 256 MB
2,aws,python,256,eu-central-1,4046,3938,108,AWS 256 MB
2,aws,python,256,eu-central-1,4045,3941,104,AWS 256 MB
2,aws,python,256,eu-central-1,4087,3945,142,AWS 256 MB
2,aws,python,256,eu-central-1,4066,3927,139,AWS 256 MB
2,aws,python,256,eu-central-1,4136,4005,131,AWS 256 MB
2,aws,python,256,eu-central-1,4059,3920,139,AWS 256 MB
2,aws,python,256,eu-central-1,4059,3926,133,AWS 256 MB
2,aws,python,256,eu-central-1,4038,3941,97,AWS 256 MB
2,aws,python,256,eu-central-1,4056,3928,128,AWS 256 MB
2,aws,python,256,eu-central-1,4121,4014,107,AWS 256 MB
2,aws,python,256,eu-central-1,4056,3903,153,AWS 256 MB
2,aws,python,256,eu-central-1,4349,3924,425,AWS 256 MB
2,aws,python,256,eu-central-1,4381,3913,468,AWS 256 MB
2,aws,python,256,eu-central-1,4042,3920,122,AWS 256 MB
2,aws,python,256,eu-central-1,4099,3964,135,AWS 256 MB
2,aws,python,256,eu-central-1,4054,3939,115,AWS 256 MB
2,aws,python,256,eu-central-1,4048,3904,144,AWS 256 MB
2,aws,python,256,eu-central-1,4051,3918,133,AWS 256 MB
2,aws,python,256,eu-central-1,4044,3899,145,AWS 256 MB
2,aws,python,256,eu-central-1,4100,3967,133,AWS 256 MB
2,aws,python,256,eu-central-1,4083,3940,143,AWS 256 MB
2,aws,python,256,eu-central-1,4062,3955,107,AWS 256 MB
2,aws,python,256,eu-central-1,4058,3914,144,AWS 256 MB
2,aws,python,256,eu-central-1,4060,3930,130,AWS 256 MB
2,aws,python,256,eu-central-1,4121,3990,131,AWS 256 MB
2,aws,python,256,eu-central-1,4037,3913,124,AWS 256 MB
2,aws,python,256,eu-central-1,4058,3926,132,AWS 256 MB
2,aws,python,256,eu-central-1,4031,3916,115,AWS 256 MB
2,aws,python,256,eu-central-1,4032,3910,122,AWS 256 MB
2,aws,python,256,eu-central-1,4088,3971,117,AWS 256 MB
2,aws,python,256,eu-central-1,4031,3911,120,AWS 256 MB
2,aws,python,256,eu-central-1,4447,3920,527,AWS 256 MB
2,aws,python,256,eu-central-1,4045,3931,114,AWS 256 MB
2,aws,python,256,eu-central-1,4104,3948,156,AWS 256 MB
2,aws,python,256,eu-central-1,4107,3989,118,AWS 256 MB
2,aws,python,256,eu-central-1,4049,3935,114,AWS 256 MB
2,aws,python,256,eu-central-1,4077,3914,163,AWS 256 MB
2,aws,python,256,eu-central-1,4029,3908,121,AWS 256 MB
2,aws,python,256,eu-central-1,4044,3910,134,AWS 256 MB
2,aws,python,256,eu-central-1,4082,3946,136,AWS 256 MB
2,aws,python,256,eu-central-1,4044,3933,111,AWS 256 MB
2,aws,python,256,eu-central-1,4040,3901,139,AWS 256 MB
2,aws,python,256,eu-central-1,4042,3924,118,AWS 256 MB
2,aws,python,256,eu-central-1,4035,3917,118,AWS 256 MB
2,aws,python,256,eu-central-1,4094,3962,132,AWS 256 MB
2,aws,python,256,eu-central-1,4037,3919,118,AWS 256 MB
2,aws,python,256,eu-central-1,4051,3921,130,AWS 256 MB
2,aws,python,256,eu-central-1,4028,3906,122,AWS 256 MB
2,aws,python,256,eu-central-1,4035,3911,124,AWS 256 MB
2,aws,python,256,eu-central-1,4110,3988,122,AWS 256 MB
2,aws,python,256,eu-central-1,4031,3903,128,AWS 256 MB
2,aws,python,256,eu-central-1,4080,3932,148,AWS 256 MB
2,aws,python,256,eu-central-1,4033,3908,125,AWS 256 MB
2,aws,python,256,eu-central-1,4035,3933,102,AWS 256 MB
2,aws,python,256,eu-central-1,4100,3998,102,AWS 256 MB
2,aws,python,256,eu-central-1,4058,3939,119,AWS 256 MB
2,aws,python,256,eu-central-1,4069,3930,139,AWS 256 MB
2,aws,python,256,eu-central-1,4058,3944,114,AWS 256 MB
2,aws,python,256,eu-central-1,4041,3922,119,AWS 256 MB
2,aws,python,256,eu-central-1,4081,3936,145,AWS 256 MB
2,aws,python,256,eu-central-1,4038,3927,111,AWS 256 MB
2,aws,python,256,eu-central-1,4035,3923,112,AWS 256 MB
2,aws,python,256,eu-central-1,4053,3922,131,AWS 256 MB
2,aws,python,256,eu-central-1,4054,3929,125,AWS 256 MB
2,aws,python,256,eu-central-1,4136,4004,132,AWS 256 MB
2,aws,python,256,eu-central-1,4027,3912,115,AWS 256 MB
2,aws,python,256,eu-central-1,4052,3929,123,AWS 256 MB
2,aws,python,256,eu-central-1,4063,3928,135,AWS 256 MB
2,aws,python,256,eu-central-1,4082,3938,144,AWS 256 MB
2,aws,python,256,eu-central-1,4089,3983,106,AWS 256 MB
2,aws,python,256,eu-central-1,4044,3926,118,AWS 256 MB
2,aws,python,256,eu-central-1,4063,3955,108,AWS 256 MB
2,aws,python,256,eu-central-1,4038,3923,115,AWS 256 MB
2,aws,python,256,eu-central-1,4130,3904,226,AWS 256 MB
2,aws,python,256,eu-central-1,4124,3979,145,AWS 256 MB
2,aws,python,256,eu-central-1,4087,3959,128,AWS 256 MB
2,aws,python,256,eu-central-1,4058,3928,130,AWS 256 MB
2,aws,python,256,eu-central-1,4052,3935,117,AWS 256 MB
2,aws,python,256,eu-central-1,4052,3941,111,AWS 256 MB
2,aws,python,256,eu-central-1,4107,3966,141,AWS 256 MB
2,aws,python,256,eu-central-1,4043,3915,128,AWS 256 MB
2,aws,python,256,eu-central-1,4050,3931,119,AWS 256 MB
2,aws,python,256,eu-central-1,4046,3890,156,AWS 256 MB
2,aws,python,256,eu-central-1,4072,3904,168,AWS 256 MB
2,aws,python,256,eu-central-1,4128,3990,138,AWS 256 MB
2,aws,python,256,eu-central-1,4053,3921,132,AWS 256 MB
2,aws,python,256,eu-central-1,4043,3910,133,AWS 256 MB
2,aws,python,256,eu-central-1,4019,3896,123,AWS 256 MB
2,aws,python,256,eu-central-1,4041,3938,103,AWS 256 MB
2,aws,python,256,eu-central-1,4095,3976,119,AWS 256 MB
2,aws,python,256,eu-central-1,4040,3917,123,AWS 256 MB
2,aws,python,256,eu-central-1,4042,3938,104,AWS 256 MB
2,aws,python,256,eu-central-1,4071,3918,153,AWS 256 MB
2,aws,python,256,eu-central-1,4150,3919,231,AWS 256 MB
2,aws,python,256,eu-central-1,4124,4017,107,AWS 256 MB
3,aws,python,512,eu-central-1,2121,1970,151,AWS 512 MB
3,aws,python,512,eu-central-1,2080,1965,115,AWS 512 MB
3,aws,python,512,eu-central-1,2078,1954,124,AWS 512 MB
3,aws,python,512,eu-central-1,2075,1940,135,AWS 512 MB
3,aws,python,512,eu-central-1,2150,1949,201,AWS 512 MB
3,aws,python,512,eu-central-1,2069,1941,128,AWS 512 MB
3,aws,python,512,eu-central-1,2056,1945,111,AWS 512 MB
3,aws,python,512,eu-central-1,2074,1945,129,AWS 512 MB
3,aws,python,512,eu-central-1,2379,1940,439,AWS 512 MB
3,aws,python,512,eu-central-1,2075,1956,119,AWS 512 MB
3,aws,python,512,eu-central-1,2199,1939,260,AWS 512 MB
3,aws,python,512,eu-central-1,2072,1940,132,AWS 512 MB
3,aws,python,512,eu-central-1,2068,1931,137,AWS 512 MB
3,aws,python,512,eu-central-1,2068,1948,120,AWS 512 MB
3,aws,python,512,eu-central-1,2068,1945,123,AWS 512 MB
3,aws,python,512,eu-central-1,2411,1947,464,AWS 512 MB
3,aws,python,512,eu-central-1,2062,1958,104,AWS 512 MB
3,aws,python,512,eu-central-1,2083,1947,136,AWS 512 MB
3,aws,python,512,eu-central-1,2093,1954,139,AWS 512 MB
3,aws,python,512,eu-central-1,2066,1950,116,AWS 512 MB
3,aws,python,512,eu-central-1,2050,1933,117,AWS 512 MB
3,aws,python,512,eu-central-1,2075,1942,133,AWS 512 MB
3,aws,python,512,eu-central-1,2062,1938,124,AWS 512 MB
3,aws,python,512,eu-central-1,2101,1949,152,AWS 512 MB
3,aws,python,512,eu-central-1,2074,1947,127,AWS 512 MB
3,aws,python,512,eu-central-1,2073,1932,141,AWS 512 MB
3,aws,python,512,eu-central-1,2070,1955,115,AWS 512 MB
3,aws,python,512,eu-central-1,2094,1973,121,AWS 512 MB
3,aws,python,512,eu-central-1,2067,1946,121,AWS 512 MB
3,aws,python,512,eu-central-1,2069,1960,109,AWS 512 MB
3,aws,python,512,eu-central-1,2069,1940,129,AWS 512 MB
3,aws,python,512,eu-central-1,2068,1933,135,AWS 512 MB
3,aws,python,512,eu-central-1,2097,1947,150,AWS 512 MB
3,aws,python,512,eu-central-1,2081,1939,142,AWS 512 MB
3,aws,python,512,eu-central-1,2080,1947,133,AWS 512 MB
3,aws,python,512,eu-central-1,2066,1952,114,AWS 512 MB
3,aws,python,512,eu-central-1,2079,1957,122,AWS 512 MB
3,aws,python,512,eu-central-1,2077,1962,115,AWS 512 MB
3,aws,python,512,eu-central-1,2078,1944,134,AWS 512 MB
3,aws,python,512,eu-central-1,2075,1960,115,AWS 512 MB
3,aws,python,512,eu-central-1,2075,1960,115,AWS 512 MB
3,aws,python,512,eu-central-1,2074,1961,113,AWS 512 MB
3,aws,python,512,eu-central-1,2069,1942,127,AWS 512 MB
3,aws,python,512,eu-central-1,2069,1956,113,AWS 512 MB
3,aws,python,512,eu-central-1,2072,1955,117,AWS 512 MB
3,aws,python,512,eu-central-1,2071,1946,125,AWS 512 MB
3,aws,python,512,eu-central-1,2082,1950,132,AWS 512 MB
3,aws,python,512,eu-central-1,2084,1948,136,AWS 512 MB
3,aws,python,512,eu-central-1,2066,1940,126,AWS 512 MB
3,aws,python,512,eu-central-1,2067,1959,108,AWS 512 MB
3,aws,python,512,eu-central-1,2061,1946,115,AWS 512 MB
3,aws,python,512,eu-central-1,2043,1947,96,AWS 512 MB
3,aws,python,512,eu-central-1,2218,1952,266,AWS 512 MB
3,aws,python,512,eu-central-1,2062,1944,118,AWS 512 MB
3,aws,python,512,eu-central-1,2062,1947,115,AWS 512 MB
3,aws,python,512,eu-central-1,2061,1959,102,AWS 512 MB
3,aws,python,512,eu-central-1,2064,1946,118,AWS 512 MB
3,aws,python,512,eu-central-1,2080,1945,135,AWS 512 MB
3,aws,python,512,eu-central-1,2079,1951,128,AWS 512 MB
3,aws,python,512,eu-central-1,2113,1946,167,AWS 512 MB
3,aws,python,512,eu-central-1,2057,1947,110,AWS 512 MB
3,aws,python,512,eu-central-1,2492,1955,537,AWS 512 MB
3,aws,python,512,eu-central-1,2062,1937,125,AWS 512 MB
3,aws,python,512,eu-central-1,2085,1959,126,AWS 512 MB
3,aws,python,512,eu-central-1,2378,1960,418,AWS 512 MB
3,aws,python,512,eu-central-1,2074,1943,131,AWS 512 MB
3,aws,python,512,eu-central-1,2103,1944,159,AWS 512 MB
3,aws,python,512,eu-central-1,2061,1936,125,AWS 512 MB
3,aws,python,512,eu-central-1,2074,1942,132,AWS 512 MB
3,aws,python,512,eu-central-1,2062,1940,122,AWS 512 MB
3,aws,python,512,eu-central-1,2065,1955,110,AWS 512 MB
3,aws,python,512,eu-central-1,2070,1935,135,AWS 512 MB
3,aws,python,512,eu-central-1,2277,1959,318,AWS 512 MB
3,aws,python,512,eu-central-1,2078,1940,138,AWS 512 MB
3,aws,python,512,eu-central-1,2054,1942,112,AWS 512 MB
3,aws,python,512,eu-central-1,2066,1929,137,AWS 512 MB
3,aws,python,512,eu-central-1,2076,1958,118,AWS 512 MB
3,aws,python,512,eu-central-1,2051,1955,96,AWS 512 MB
3,aws,python,512,eu-central-1,2495,1942,553,AWS 512 MB
3,aws,python,512,eu-central-1,2059,1953,106,AWS 512 MB
3,aws,python,512,eu-central-1,2064,1955,109,AWS 512 MB
3,aws,python,512,eu-central-1,2067,1933,134,AWS 512 MB
3,aws,python,512,eu-central-1,2087,1947,140,AWS 512 MB
3,aws,python,512,eu-central-1,2006,1950,56,AWS 512 MB
3,aws,python,512,eu-central-1,2063,1935,128,AWS 512 MB
3,aws,python,512,eu-central-1,2062,1948,114,AWS 512 MB
3,aws,python,512,eu-central-1,2066,1951,115,AWS 512 MB
3,aws,python,512,eu-central-1,2066,1959,107,AWS 512 MB
3,aws,python,512,eu-central-1,2047,1948,99,AWS 512 MB
3,aws,python,512,eu-central-1,2065,1948,117,AWS 512 MB
3,aws,python,512,eu-central-1,2061,1949,112,AWS 512 MB
3,aws,python,512,eu-central-1,2260,1944,316,AWS 512 MB
3,aws,python,512,eu-central-1,2064,1948,116,AWS 512 MB
3,aws,python,512,eu-central-1,2041,1946,95,AWS 512 MB
3,aws,python,512,eu-central-1,2259,1960,299,AWS 512 MB
3,aws,python,512,eu-central-1,2058,1933,125,AWS 512 MB
3,aws,python,512,eu-central-1,2061,1934,127,AWS 512 MB
3,aws,python,512,eu-central-1,2075,1944,131,AWS 512 MB
3,aws,python,512,eu-central-1,2039,1915,124,AWS 512 MB
3,aws,python,512,eu-central-1,2286,1959,327,AWS 512 MB
4,aws,python,1024,eu-central-1,1341,992,349,AWS 1024 MB
4,aws,python,1024,eu-central-1,1073,1007,66,AWS 1024 MB
4,aws,python,1024,eu-central-1,1071,1000,71,AWS 1024 MB
4,aws,python,1024,eu-central-1,1064,997,67,AWS 1024 MB
4,aws,python,1024,eu-central-1,1066,1002,64,AWS 1024 MB
4,aws,python,1024,eu-central-1,1071,997,74,AWS 1024 MB
4,aws,python,1024,eu-central-1,1079,1009,70,AWS 1024 MB
4,aws,python,1024,eu-central-1,1070,1003,67,AWS 1024 MB
4,aws,python,1024,eu-central-1,1061,992,69,AWS 1024 MB
4,aws,python,1024,eu-central-1,1074,981,93,AWS 1024 MB
4,aws,python,1024,eu-central-1,1077,1010,67,AWS 1024 MB
4,aws,python,1024,eu-central-1,1153,994,159,AWS 1024 MB
4,aws,python,1024,eu-central-1,1090,1013,77,AWS 1024 MB
4,aws,python,1024,eu-central-1,1092,1001,91,AWS 1024 MB
4,aws,python,1024,eu-central-1,1075,999,76,AWS 1024 MB
4,aws,python,1024,eu-central-1,1061,1001,60,AWS 1024 MB
4,aws,python,1024,eu-central-1,1078,997,81,AWS 1024 MB
4,aws,python,1024,eu-central-1,1103,1001,102,AWS 1024 MB
4,aws,python,1024,eu-central-1,1058,994,64,AWS 1024 MB
4,aws,python,1024,eu-central-1,1108,1005,103,AWS 1024 MB
4,aws,python,1024,eu-central-1,1078,1002,76,AWS 1024 MB
4,aws,python,1024,eu-central-1,1055,996,59,AWS 1024 MB
4,aws,python,1024,eu-central-1,1048,998,50,AWS 1024 MB
4,aws,python,1024,eu-central-1,1070,999,71,AWS 1024 MB
4,aws,python,1024,eu-central-1,1071,998,73,AWS 1024 MB
4,aws,python,1024,eu-central-1,1081,1001,80,AWS 1024 MB
4,aws,python,1024,eu-central-1,1085,1000,85,AWS 1024 MB
4,aws,python,1024,eu-central-1,1084,1001,83,AWS 1024 MB
4,aws,python,1024,eu-central-1,1106,1008,98,AWS 1024 MB
4,aws,python,1024,eu-central-1,1067,1003,64,AWS 1024 MB
4,aws,python,1024,eu-central-1,1063,1002,61,AWS 1024 MB
4,aws,python,1024,eu-central-1,1086,1010,76,AWS 1024 MB
4,aws,python,1024,eu-central-1,1058,996,62,AWS 1024 MB
4,aws,python,1024,eu-central-1,1057,993,64,AWS 1024 MB
4,aws,python,1024,eu-central-1,1059,997,62,AWS 1024 MB
4,aws,python,1024,eu-central-1,1071,997,74,AWS 1024 MB
4,aws,python,1024,eu-central-1,1074,1002,72,AWS 1024 MB
4,aws,python,1024,eu-central-1,1062,1008,54,AWS 1024 MB
4,aws,python,1024,eu-central-1,1065,999,66,AWS 1024 MB
4,aws,python,1024,eu-central-1,1076,1006,70,AWS 1024 MB
4,aws,python,1024,eu-central-1,1064,1003,61,AWS 1024 MB
4,aws,python,1024,eu-central-1,1550,1004,546,AWS 1024 MB
4,aws,python,1024,eu-central-1,1075,1003,72,AWS 1024 MB
4,aws,python,1024,eu-central-1,1055,993,62,AWS 1024 MB
4,aws,python,1024,eu-central-1,1070,998,72,AWS 1024 MB
4,aws,python,1024,eu-central-1,1066,993,73,AWS 1024 MB
4,aws,python,1024,eu-central-1,1072,990,82,AWS 1024 MB
4,aws,python,1024,eu-central-1,1051,994,57,AWS 1024 MB
4,aws,python,1024,eu-central-1,1072,1005,67,AWS 1024 MB
4,aws,python,1024,eu-central-1,1066,1009,57,AWS 1024 MB
4,aws,python,1024,eu-central-1,1310,1008,302,AWS 1024 MB
4,aws,python,1024,eu-central-1,1066,999,67,AWS 1024 MB
4,aws,python,1024,eu-central-1,1298,999,299,AWS 1024 MB
4,aws,python,1024,eu-central-1,1066,999,67,AWS 1024 MB
4,aws,python,1024,eu-central-1,1081,996,85,AWS 1024 MB
4,aws,python,1024,eu-central-1,1061,1001,60,AWS 1024 MB
4,aws,python,1024,eu-central-1,1080,1003,77,AWS 1024 MB
4,aws,python,1024,eu-central-1,1077,997,80,AWS 1024 MB
4,aws,python,1024,eu-central-1,1057,992,65,AWS 1024 MB
4,aws,python,1024,eu-central-1,1065,992,73,AWS 1024 MB
4,aws,python,1024,eu-central-1,1075,991,84,AWS 1024 MB
4,aws,python,1024,eu-central-1,1056,989,67,AWS 1024 MB
4,aws,python,1024,eu-central-1,1050,981,69,AWS 1024 MB
4,aws,python,1024,eu-central-1,1073,996,77,AWS 1024 MB
4,aws,python,1024,eu-central-1,1055,994,61,AWS 1024 MB
4,aws,python,1024,eu-central-1,1069,997,72,AWS 1024 MB
4,aws,python,1024,eu-central-1,1070,1000,70,AWS 1024 MB
4,aws,python,1024,eu-central-1,1066,997,69,AWS 1024 MB
4,aws,python,1024,eu-central-1,1085,1007,78,AWS 1024 MB
4,aws,python,1024,eu-central-1,1082,1003,79,AWS 1024 MB
4,aws,python,1024,eu-central-1,1405,1000,405,AWS 1024 MB
4,aws,python,1024,eu-central-1,1086,1020,66,AWS 1024 MB
4,aws,python,1024,eu-central-1,1540,995,545,AWS 1024 MB
4,aws,python,1024,eu-central-1,1084,1006,78,AWS 1024 MB
4,aws,python,1024,eu-central-1,1057,997,60,AWS 1024 MB
4,aws,python,1024,eu-central-1,1082,1007,75,AWS 1024 MB
4,aws,python,1024,eu-central-1,1076,1006,70,AWS 1024 MB
4,aws,python,1024,eu-central-1,1055,992,63,AWS 1024 MB
4,aws,python,1024,eu-central-1,1075,998,77,AWS 1024 MB
4,aws,python,1024,eu-central-1,1075,1016,59,AWS 1024 MB
4,aws,python,1024,eu-central-1,1073,997,76,AWS 1024 MB
4,aws,python,1024,eu-central-1,1075,1010,65,AWS 1024 MB
4,aws,python,1024,eu-central-1,1069,1003,66,AWS 1024 MB
4,aws,python,1024,eu-central-1,1093,1015,78,AWS 1024 MB
4,aws,python,1024,eu-central-1,1069,1009,60,AWS 1024 MB
4,aws,python,1024,eu-central-1,1088,996,92,AWS 1024 MB
4,aws,python,1024,eu-central-1,1068,995,73,AWS 1024 MB
4,aws,python,1024,eu-central-1,1069,993,76,AWS 1024 MB
4,aws,python,1024,eu-central-1,1173,992,181,AWS 1024 MB
4,aws,python,1024,eu-central-1,1064,991,73,AWS 1024 MB
4,aws,python,1024,eu-central-1,1093,1009,84,AWS 1024 MB
4,aws,python,1024,eu-central-1,1065,1002,63,AWS 1024 MB
4,aws,python,1024,eu-central-1,1062,1005,57,AWS 1024 MB
4,aws,python,1024,eu-central-1,1066,999,67,AWS 1024 MB
4,aws,python,1024,eu-central-1,1072,1010,62,AWS 1024 MB
4,aws,python,1024,eu-central-1,1063,1005,58,AWS 1024 MB
4,aws,python,1024,eu-central-1,1076,992,84,AWS 1024 MB
4,aws,python,1024,eu-central-1,1251,1002,249,AWS 1024 MB
4,aws,python,1024,eu-central-1,1078,1002,76,AWS 1024 MB
4,aws,python,1024,eu-central-1,1078,1008,70,AWS 1024 MB
5,aws,python,2048,eu-central-1,651,558,93,AWS 2048 MB
5,aws,python,2048,eu-central-1,632,571,61,AWS 2048 MB
5,aws,python,2048,eu-central-1,637,565,72,AWS 2048 MB
5,aws,python,2048,eu-central-1,620,561,59,AWS 2048 MB
5,aws,python,2048,eu-central-1,625,558,67,AWS 2048 MB
5,aws,python,2048,eu-central-1,645,557,88,AWS 2048 MB
5,aws,python,2048,eu-central-1,617,556,61,AWS 2048 MB
5,aws,python,2048,eu-central-1,625,555,70,AWS 2048 MB
5,aws,python,2048,eu-central-1,626,558,68,AWS 2048 MB
5,aws,python,2048,eu-central-1,683,556,127,AWS 2048 MB
5,aws,python,2048,eu-central-1,627,556,71,AWS 2048 MB
5,aws,python,2048,eu-central-1,636,555,81,AWS 2048 MB
5,aws,python,2048,eu-central-1,620,553,67,AWS 2048 MB
5,aws,python,2048,eu-central-1,632,557,75,AWS 2048 MB
5,aws,python,2048,eu-central-1,640,562,78,AWS 2048 MB
5,aws,python,2048,eu-central-1,651,575,76,AWS 2048 MB
5,aws,python,2048,eu-central-1,629,557,72,AWS 2048 MB
5,aws,python,2048,eu-central-1,645,574,71,AWS 2048 MB
5,aws,python,2048,eu-central-1,618,555,63,AWS 2048 MB
5,aws,python,2048,eu-central-1,632,557,75,AWS 2048 MB
5,aws,python,2048,eu-central-1,646,555,91,AWS 2048 MB
5,aws,python,2048,eu-central-1,628,556,72,AWS 2048 MB
5,aws,python,2048,eu-central-1,609,552,57,AWS 2048 MB
5,aws,python,2048,eu-central-1,633,555,78,AWS 2048 MB
5,aws,python,2048,eu-central-1,632,555,77,AWS 2048 MB
5,aws,python,2048,eu-central-1,614,554,60,AWS 2048 MB
5,aws,python,2048,eu-central-1,615,557,58,AWS 2048 MB
5,aws,python,2048,eu-central-1,616,559,57,AWS 2048 MB
5,aws,python,2048,eu-central-1,630,556,74,AWS 2048 MB
5,aws,python,2048,eu-central-1,628,555,73,AWS 2048 MB
5,aws,python,2048,eu-central-1,631,559,72,AWS 2048 MB
5,aws,python,2048,eu-central-1,623,557,66,AWS 2048 MB
5,aws,python,2048,eu-central-1,626,556,70,AWS 2048 MB
5,aws,python,2048,eu-central-1,635,556,79,AWS 2048 MB
5,aws,python,2048,eu-central-1,620,554,66,AWS 2048 MB
5,aws,python,2048,eu-central-1,620,553,67,AWS 2048 MB
5,aws,python,2048,eu-central-1,628,553,75,AWS 2048 MB
5,aws,python,2048,eu-central-1,617,553,64,AWS 2048 MB
5,aws,python,2048,eu-central-1,629,553,76,AWS 2048 MB
5,aws,python,2048,eu-central-1,645,576,69,AWS 2048 MB
5,aws,python,2048,eu-central-1,637,557,80,AWS 2048 MB
5,aws,python,2048,eu-central-1,626,555,71,AWS 2048 MB
5,aws,python,2048,eu-central-1,624,552,72,AWS 2048 MB
5,aws,python,2048,eu-central-1,635,550,85,AWS 2048 MB
5,aws,python,2048,eu-central-1,632,554,78,AWS 2048 MB
5,aws,python,2048,eu-central-1,614,554,60,AWS 2048 MB
5,aws,python,2048,eu-central-1,622,551,71,AWS 2048 MB
5,aws,python,2048,eu-central-1,631,555,76,AWS 2048 MB
5,aws,python,2048,eu-central-1,631,554,77,AWS 2048 MB
5,aws,python,2048,eu-central-1,623,556,67,AWS 2048 MB
5,aws,python,2048,eu-central-1,952,554,398,AWS 2048 MB
5,aws,python,2048,eu-central-1,624,554,70,AWS 2048 MB
5,aws,python,2048,eu-central-1,633,569,64,AWS 2048 MB
5,aws,python,2048,eu-central-1,640,553,87,AWS 2048 MB
5,aws,python,2048,eu-central-1,615,551,64,AWS 2048 MB
5,aws,python,2048,eu-central-1,644,570,74,AWS 2048 MB
5,aws,python,2048,eu-central-1,683,590,93,AWS 2048 MB
5,aws,python,2048,eu-central-1,637,568,69,AWS 2048 MB
5,aws,python,2048,eu-central-1,662,574,88,AWS 2048 MB
5,aws,python,2048,eu-central-1,642,573,69,AWS 2048 MB
5,aws,python,2048,eu-central-1,644,569,75,AWS 2048 MB
5,aws,python,2048,eu-central-1,1105,562,543,AWS 2048 MB
5,aws,python,2048,eu-central-1,643,573,70,AWS 2048 MB
5,aws,python,2048,eu-central-1,657,572,85,AWS 2048 MB
5,aws,python,2048,eu-central-1,661,587,74,AWS 2048 MB
5,aws,python,2048,eu-central-1,640,571,69,AWS 2048 MB
5,aws,python,2048,eu-central-1,627,569,58,AWS 2048 MB
5,aws,python,2048,eu-central-1,655,576,79,AWS 2048 MB
5,aws,python,2048,eu-central-1,656,571,85,AWS 2048 MB
5,aws,python,2048,eu-central-1,664,568,96,AWS 2048 MB
5,aws,python,2048,eu-central-1,638,567,71,AWS 2048 MB
5,aws,python,2048,eu-central-1,630,571,59,AWS 2048 MB
5,aws,python,2048,eu-central-1,640,572,68,AWS 2048 MB
5,aws,python,2048,eu-central-1,678,572,106,AWS 2048 MB
5,aws,python,2048,eu-central-1,645,574,71,AWS 2048 MB
5,aws,python,2048,eu-central-1,671,591,80,AWS 2048 MB
5,aws,python,2048,eu-central-1,635,569,66,AWS 2048 MB
5,aws,python,2048,eu-central-1,649,573,76,AWS 2048 MB
5,aws,python,2048,eu-central-1,639,571,68,AWS 2048 MB
5,aws,python,2048,eu-central-1,652,582,70,AWS 2048 MB
5,aws,python,2048,eu-central-1,660,565,95,AWS 2048 MB
5,aws,python,2048,eu-central-1,653,568,85,AWS 2048 MB
5,aws,python,2048,eu-central-1,636,568,68,AWS 2048 MB
5,aws,python,2048,eu-central-1,644,584,60,AWS 2048 MB
5,aws,python,2048,eu-central-1,650,569,81,AWS 2048 MB
5,aws,python,2048,eu-central-1,641,569,72,AWS 2048 MB
5,aws,python,2048,eu-central-1,650,573,77,AWS 2048 MB
5,aws,python,2048,eu-central-1,643,568,75,AWS 2048 MB
5,aws,python,2048,eu-central-1,655,569,86,AWS 2048 MB
5,aws,python,2048,eu-central-1,656,572,84,AWS 2048 MB
5,aws,python,2048,eu-central-1,623,568,55,AWS 2048 MB
5,aws,python,2048,eu-central-1,643,577,66,AWS 2048 MB
5,aws,python,2048,eu-central-1,643,585,58,AWS 2048 MB
5,aws,python,2048,eu-central-1,654,573,81,AWS 2048 MB
5,aws,python,2048,eu-central-1,631,568,63,AWS 2048 MB
5,aws,python,2048,eu-central-1,659,572,87,AWS 2048 MB
5,aws,python,2048,eu-central-1,656,572,84,AWS 2048 MB
5,aws,python,2048,eu-central-1,653,570,83,AWS 2048 MB
5,aws,python,2048,eu-central-1,642,572,70,AWS 2048 MB
5,aws,python,2048,eu-central-1,649,570,79,AWS 2048 MB
